//2000 Phrases Hanzi - Pinyin - (keyword) Translation
这里有一些咖啡。	 zhèlǐ yǒu yìxiē kāfēi.	(一些: yīxiē) You can get some coffee here.
我们需要一些帮助。	 wǒmen xūyào yìxiē bāngzhù.	(一些: yīxiē) We need some help.
给我一些时间。	 gěi wǒ yìxiē shíjiān.	(一些: yīxiē) Give me some time.
我买了一些水果。	 wǒ mǎi le yìxiē shuǐguǒ.	(一些: yīxiē) I bought some fruits.
我想喝一些牛奶。	 wǒ xiǎng hē yìxiē niúnǎi.	(一些: yīxiē) I want to drink some milk.
我吃了一些牛肉。	 wǒ chī le yìxiē niúròu.	(一些: yīxiē) I ate some beef.
我买了一些苹果。	 wǒ mǎi le yìxiē píngguǒ.	(一些: yīxiē) I bought some apples.
我买了一些西红柿。	 wǒ mǎi le yìxiē xīhóngshì.	(一些: yīxiē) I bought some tomatoes.
我一切都很好。	 wǒ yíqiè dōu hěn hǎo.	(一切: yīqiè) I am quite all right now.
一切都没了。	 yíqiè dōu méile.	(一切: yīqiè) It's all gone.
现在是三点一刻。	 xiànzài shì sān diǎn yí kè.	(一刻: yīkè) It is a quarter past three.
差一刻五点	 chà yí kè wǔ diǎn	(一刻: yīkè) fifteen minutes til 5 o'clock
七点一刻	 qī diǎn yí kè	(一刻: yīkè) 0,302083333333333
九点一刻	 jiǔ diǎn yí kè	(一刻: yīkè) 0,385416666666667
十一点一刻	 shíyī diǎn yí kè	(一刻: yīkè) 0,46875
五点一刻	 wǔ diǎn yí kè	(一刻: yīkè) 0,21875
三天一直下雨。	 sān tiān yìzhí xiàyǔ.	(一直: yīzhí) It's been raining non-stop for three days.
她一直很喜欢上海。	 tā yìzhí hěn xǐhuan shànghǎi.	(一直: yīzhí) She has always liked Shanghai a lot.
我一直很忙。	 wǒ yìzhí hěn máng.	(一直: yīzhí) I am always very busy.
我一直很爱你！	 wǒ yìzhí hěn ài nǐ!	(一直: yīzhí) I've always loved you a lot!
我一般7点钟起床。	 wǒ yìbān 7 diǎnzhōng qǐchuáng.	(一般: yībān) I usually get up at 7 o'clock.
每隔一行写。	 měigé yìxíng xiě.	(一行: yīxíng) Write on every other line.
这二人一见钟情。	 zhè èr rén yíjiànzhōngqíng.	(一见钟情: yījiànzhōngqíng) The two fell in love with each other at the first sight.
我们一起吃饭。	 wǒmen yìqǐ chīfàn.	(一起: yīqǐ) Let's eat together.
我们一起坐地铁上班。	 wǒmen yìqǐ zuò dìtiě shàngbān.	(一起: yīqǐ) We take the metro together to work.
我和他一起工作。	 wǒ hé tā yìqǐ gōngzuò.	(一起: yīqǐ) He and I work together.
我和同事一起开会。	 wǒ hé tóngshì yìqǐ kāihuì.	(一起: yīqǐ) My co-worker and I hold a meeting together.
一边走路一边看美女。	 yìbiān zǒulù yìbiān kàn měinǚ.	(一边: yībiān) Looking at pretty girls while walking on the road.
我丈夫在医院工作。	 wǒ zhàngfu zài yīyuàn gōngzuò.	(丈夫: zhàngfū) My husband works in a hospital.
顾客减少了三分之一。	 gùkè jiǎnshǎo le sānfēnzhīyī.	(三分之一: sānfēnzhīyī) Customers decreased by a third.
他买了一个三明治。	 tā mǎi le yíge sānmíngzhì.	(三明治: sānmíngzhì) He bought one sandwich.
你会做三明治吗？	 nǐ huì zuò sānmíngzhì ma?	(三明治: sānmíngzhì) Can you make a sandwich?
三明治很好做。	 sānmíngzhì hěn hǎo zuò.	(三明治: sānmíngzhì) Sandwiches are easy to make.
三明治很难做。	 sānmíngzhì hěn nán zuò.	(三明治: sānmíngzhì) Sandwiches are hard to make.
四个三明治	 sìge sānmíngzhì	(三明治: sānmíngzhì) four sandwiches
现在是上午10点。	 xiànzài shì shàngwǔ 10 diǎn.	(上午: shàngwǔ) Now it is 10:00.
昨天上午下大雨。	 zuótiān shàngwǔ xià dàyǔ.	(上午: shàngwǔ) It rained hard yesterday morning.
星期三上午九点半	 xīngqīsān shàngwǔ jiǔ diǎn bàn	(上午: shàngwǔ) Wednesday at 9:30 a.m.
星期三上午九点	 xīngqīsān shàngwǔ jiǔ diǎn	(上午: shàngwǔ) Wednesday at 9 o'clock a.m.
上午十点半	 shàngwǔ shí diǎn bàn	(上午: shàngwǔ) 10:30 a.m.
她上午学了英语。	 tā shàngwǔ xué le yīngyǔ.	(上午: shàngwǔ) She studied English in the morning.
我上午慢跑。	 wǒ shàngwǔ mànpǎo.	(上午: shàngwǔ) I jog in the morning.
明天上午行吗？	 míngtiān shàngwǔ xíng ma?	(上午: shàngwǔ) Is tomorrow morning any good?
有人看见他上楼。	 yǒu rén kànjiàn tā shànglóu.	(上楼: shànglóu) He was seen to go upstairs.
我们坐电梯上楼。	 wǒmen zuò diàntī shànglóu.	(上楼: shànglóu) We took the elevator upstairs.
我在上海。	 wǒ zài shànghǎi.	(上海: shànghǎi) I'm in Shanghai.
我到上海。	 wǒ dào shànghǎi.	(上海: shànghǎi) I arrived at Shanghai.
我们都在上海。	 wǒmen dōu zài shànghǎi.	(上海: shànghǎi) We are all in Shanghai.
我要去上海。	 wǒ yào qù shànghǎi.	(上海: shànghǎi) I want to go to Shanghai.
我住在上海。	 wǒ zhù zài shànghǎi.	(上海: shànghǎi) I live in Shanghai.
你可以坐船去上海。	 nǐ kěyǐ zuò chuán qù shànghǎi.	(上海: shànghǎi) You can boat to Shanghai.
她一直很喜欢上海。	 tā yìzhí hěn xǐhuan shànghǎi.	(上海: shànghǎi) She has always liked Shanghai a lot.
以前我住在上海。	 yǐqián wǒ zhù zài shànghǎi.	(上海: shànghǎi) Before, I lived in Shanghai.
北京和上海一样吗？	 běijīng hé shànghǎi yíyàng ma?	(上海: shànghǎi) Are Beijing and Shanghai alike?
在上海买的衣服	 zài shànghǎi mǎi de yīfu	(上海: shànghǎi) The clothes that were bought in Shanghai.
上海什么都贵。	 shànghǎi shénme dōu guì.	(上海: shànghǎi) Everything in Shanghai is expensive.
纽约比上海冷。	 niǔyuē bǐ shànghǎi lěng.	(上海: shànghǎi) New York is colder than Shanghai.
上海和纽约差不多。	 shànghǎi hé niǔyuē chàbuduō.	(上海: shànghǎi) Shanghai and New York are basically the same.
我在上海工作。	 wǒ zài shànghǎi gōngzuò.	(上海: shànghǎi) I am working in Shanghai.
北京和上海差不多热。	 běijīng hé shànghǎi chàbuduō rè.	(上海: shànghǎi) Beijing and Shanghai are both just as hot.
我觉得上海很好玩。	 wǒ juéde shànghǎi hěn hǎowán.	(上海: shànghǎi) I think Shanghai is a lot of fun.
上海比别的城市方便。	 shànghǎi bǐ biéde chéngshì fāngbiàn.	(上海: shànghǎi) Shanghai is more convenient than other cities.
上海没有北京冷。	 shànghǎi méiyǒu běijīng lěng.	(上海: shànghǎi) Shanghai is not as cold as Beijing.
上海的冬天有点冷。	 shànghǎi de dōngtiān yǒudiǎn lěng.	(上海: shànghǎi) Winter in Shanghai is a bit too cold.
上海的美女	 shànghǎi de měinǚ	(上海: shànghǎi) Shanghai's beautiful women
上海还是北京？	 shànghǎi háishi běijīng?	(上海: shànghǎi) Shanghai or Beijing?
住在上海非常方便。	 zhù zài shànghǎi fēicháng fāngbiàn.	(上海: shànghǎi) It is very convenient to live in Shanghai.
星期一我们要上班。	 xīngqīyī wǒmen yào shàngbān.	(上班: shàngbān) We will go to work on Monday.
我要去上班。	 wǒ yào qù shàngbān.	(上班: shàngbān) I want to go to work.
我现在在上班。	 wǒ xiànzài zài shàngbān.	(上班: shàngbān) I am working now.
明天我们要上班。	 míngtiān wǒmen yào shàngbān.	(上班: shàngbān) We need to work tomorrow.
我在一个公司上班。	 wǒ zài yíge gōngsī shàng	(上班: shàngbān) I work in a company.
我今天必须去上班。	 zwǒ jīntiān bìxū qù shàngbān.	(上班: shàngbān) I have to go to work today.
我每天都要上班。	 wǒ měitiān dōu yào shàngbān.	(上班: shàngbān) I have to go to work every day.
我们一起坐地铁上班。	 wǒmen yìqǐ zuò dìtiě shàngbān.	(上班: shàngbān) We take the metro together to work.
我妻子上班去了。	 wǒ qīzi shàngbān qù le.	(上班: shàngbān) My wife went to work.
八点半开始上课。	 bā diǎn bàn kāishǐ shàngkè.	(上课: shàngkè) Class doesn't begin until eight-thirty.
他没有上课。	 tā méiyǒu shàngkè.	(上课: shàngkè) He did not go to class.
现在，我们上课。	 xiànzài, wǒmen shàngkè.	(上课: shàngkè) Now, we are in class.
今天我不去上课。	 jīntiān wǒ bú qù shàngkè.	(上课: shàngkè) Today I am not going to class.
你今天上不上课？	 nǐ jīntiān shàng bu shàngkè?	(上课: shàngkè) Did you go to class today or not?
银行下午5点关门。	 yínháng xiàwǔ 5 diǎn guānmén.	(下午: xiàwǔ) 17:00 closed bank.
每天下午一点	 měitiān xiàwǔ yìdiǎn	(下午: xiàwǔ) Every day at 1 o'clock p.m.
每天下午一点半	 měitiān xiàwǔ yìdiǎn bàn	(下午: xiàwǔ) Every day at 1:30 p.m.
下午两点半	 xiàwǔ liǎng diǎn bàn	(下午: xiàwǔ) 2:30 p.m.
我明天下午休假。	 wǒ míngtiān xiàwǔ xiūjià.	(下午: xiàwǔ) I am taking tomorrow afternoon off.
您下午做啥呢？	 nín xiàwǔ zuò shá ne?	(下午: xiàwǔ) So what will you do in the afternoon?
我下午去卖车。	 wǒ xiàwǔ qù mài chē.	(下午: xiàwǔ) I'm going to go sell my car this afternoon.
下午可能会下雪。	 xiàwǔ kěnéng huì xiàxuě.	(下午: xiàwǔ) It may snow in the afternoon.
今天下午四点半	 jīntiān xiàwǔ sì diǎn bàn	(下午: xiàwǔ) 4:30 p.m. this afternoon.
下午我会去超市。	 xiàwǔ wǒ huì qù chāoshì.	(下午: xiàwǔ) In the afternoon, I'll go to the supermarket.
我们下午有个会议。	 wǒmen xiàwǔ yǒu ge huìyì.	(下午: xiàwǔ) We have a meeting in the afternoon.
我明天下午有空。	 wǒ míngtiān xiàwǔ yǒu kōng.	(下午: xiàwǔ) I will be free tomorrow afternoon.
你下午有空吗?。	 nǐ xiàwǔ yǒu kōng ma?.	(下午: xiàwǔ) Are you free in the afternoon?
比尔下周会回来。	 bǐ'ěr xiàzhōu huì huílai.	(下周: xiàzhōu) Bill will return next week.
我下周去美国旅行。	 wǒ xiàzhōu qù měiguó lǚxíng.	(下周: xiàzhōu) Next week I go to U.S. to travel.
我们刚下班。	 wǒmen gāng xiàbān.	(下班: xiàbān) We just got off work.
我们八点下班。	 wǒmen bā diǎn xiàbān.	(下班: xiàbān) We work eight.
你快下班了吗？	 nǐ kuài xiàbān le ma?	(下班: xiàbān) Are you going to get off work soon?
你快要下班了吗？	 nǐ kuàiyào xiàbān le ma?	(下班: xiàbān) Will you be getting off work soon?
他下礼拜要考试。	 tā xià lǐbài yào kǎoshì.	(下礼拜: xiàlǐbài) He has a test next week.
今天下雪。	 jīntiān xiàxuě.	(下雪: xiàxuě) It's snowing today.
下午可能会下雪。	 xiàwǔ kěnéng huì xiàxuě.	(下雪: xiàxuě) It may snow in the afternoon.
这个地方从不下雪。	 zhège dìfang cóng búxià xuě.	(下雪: xiàxuě) It never snows at this place.
这个地方从来不下雪。	 zhège dìfang cóngláibù xiàxuě.	(下雪: xiàxuě) It never snows at this place.
呀,下雪了！	 ya,xiàxuě le!	(下雪: xiàxuě) Yeah, snow!
她钱不够。	 tā qián búgòu.	(不够: bùgòu) She is hard up for money.
你不必吃。	 nǐ búbì chī.	(不必: bùbì) You don't have to eat.
我们老板还不错。	 wǒmen lǎobǎn hái búcuò.	(不错: bùcuò) Our boss is not too bad.
这把椅子很丑。	 zhè bǎ yǐzi hěn chǒu.	(丑: chǒu) This chair is ugly.
他又丑又笨。	 tā yòu chǒu yòu bèn.	(丑: chǒu) He is both ugly and stupid.
世界上有很多国家。	 shìjiè shàng yǒu hěn duō guójiā.	(世界: shìjiè) There are many countries in the world.
现在是二十一世纪了。	 xiànzài shì èrshíyīshìjì le.	(世纪: shìjì) Now is the twenty-first century.
你的书包丢了？	 nǐ de shūbāo diū le?	(丢: diū) You lost your bag?
多丢人啊！	 duō diūrén a!	(丢人: diūrén) How shameful!
现在环境污染越来越严重。	 xiànzài huánjìng wūrǎn yuèláiyuè yánzhòng.	(严重: yánzhòng) Now more and more serious environmental pollution.
现在才中午。	 xiànzài cái zhōngwǔ.	(中午: zhōngwǔ) It is just noon.
Ken中午以前会在家。	 kèi yì ēn zhōngwǔ yǐqián huì zài jiā.	(中午: zhōngwǔ) Ken will be at home until noon.
她应该中午到那里。	 tā yīnggāi zhōngwǔ dào nàli.	(中午: zhōngwǔ) She should be there at noon.
我今天中午去火车站。	 wǒ jīntiān zhōngwǔ qù huǒchēzhàn.	(中午: zhōngwǔ) I went to the train station at noon today.
你中午吃了什么？	 nǐ zhōngwǔ chī le shénme?	(中午: zhōngwǔ) What did you eat in the afternoon?
让她中午过来。	 ràng tā zhōngwǔ guòlái.	(中午: zhōngwǔ) Tell her to come at noon.
不要站在路中间。	 bú yào zhàn zài lù zhōngjiān.	(中间: zhōngjiān) Don't stand in the middle of the road.
我为你工作。	 wǒ wèi nǐ gōngzuò.	(为: wèi) I work for you.
水果以苹果为最佳。	 shuǐguǒ yǐ píngguǒ wèi zuìjiā.	(为: wèi) Apples are the best fruit.
请你说一下为什么。	 qǐng nǐ shuō yíxià wèishénme.	(为什么: wèishéme) Please say why.
你究竟为什么哭呢？	 nǐ jiūjìng wèishénme kū ne?	(为什么: wèishéme) Why you crying?
你为什么总是这么忙？	 nǐ wèishénme zǒngshì zhème máng?	(为什么: wèishéme) Why are you always so busy?
你为什么来这里啊？	 nǐ wèishénme lái zhèlǐ a?	(为什么: wèishéme) What are you doing coming here?
我早饭主要吃水果。	 wǒ zǎofàn zhǔyào chī shuǐguǒ.	(主要: zhǔyào) I mostly have fruit for breakfast.
会议两点钟举行。	 huìyì liǎng diǎnzhōng jǔxíng.	(举行: jǔxíng) Meeting held two o'clock.
我们之间好像有误会。	 wǒmen zhījiān hǎoxiàng yǒu wùhuì.	(之间: zhījiān) There is a misunderstanding between us seems.
二乘以二等于四。	 èr chéng yǐ èrděng yú sì.	(乘以: chéngyǐ) Two times two is four.
四乘以二等于八。	 sì chéng yǐ èrděng yú bā.	(乘以: chéngyǐ) Four multiplied by two is eight.
欢迎您乘坐本次航班。	 huānyíng nín chéngzuò běn cì hángbān.	(乘坐: chéngzuò) Welcome aboard this flight.
他也许明天能来。	 tā yěxǔ míngtiān néng lái.	(也许: yěxǔ) He may be able to come tomorrow.
饭前洗手是好习惯。	 fàn qián xǐshǒu shì hǎo xíguàn.	(习惯: xíguàn) Washing hands before meals is a good habit.
这是书。	 zhè shì shū.	(书: shū) This is a book.
这是书。	 zhè shì shū.	(书: shū) This is a book.
我要书。	 wǒ yào shū.	(书: shū) I want the book.
这是书。	 zhè shì shū.	(书: shū) This is a book.
看这本书。	 kàn zhè běn shū.	(书: shū) Read this book.
看这本书。	 kàn zhè běn shū.	(书: shū) Read this book.
看这本书。	 kàn zhè běn shū.	(书: shū) Read this book.
这是汉语书。	 zhè shì hànyǔ shū.	(书: shū) This is a Chinese language book.
她在看书。	 tā zài kàn shū.	(书: shū) She is reading.
随便选三本书。	 suíbiàn xuǎn sān běn shū.	(书: shū) Choose three books at random.
这是一本书。	 zhè shì yì běn shū.	(书: shū) This is a book.
他喜欢这本书。	 tā xǐhuan zhè běn shū.	(书: shū) He likes this book.
这是我的书。	 zhè shì wǒ de shū.	(书: shū) This is my book.
我有三本书。	 wǒ yǒu sān běn shū.	(书: shū) I have three books.
我还少本书。	 wǒ hái shǎo běn shū.	(书: shū) I also little book.
B:这是书。	 bì:zhè shì shū.	(书: shū) This is a book.
他在图书馆看书。	 tā zài túshūguǎn kàn shū.	(书: shū) He is reading in the library.
你选哪本书？	 nǐ xuǎn nǎ běn shū?	(书: shū) Which one of the books is your pick?
你有多少本书？	 nǐ yǒu duōshǎo běn shū?	(书: shū) How many books do you have?
你有几本书?。	 nǐ yǒu jǐ běn shū?.	(书: shū) How many books do you have?
我没书可读。	 wǒ méi shū kě dú.	(书: shū) I have no books to read.
我没书可读。	 wǒ méi shū kě dú.	(书: shū) I have no books to read.
我在看书呢。	 wǒ zài kàn shū ne.	(书: shū) I'm reading it.
书在桌子上。	 shū zài zhuōzi shàng.	(书: shū) The book is on the table.
书在桌子上。	 shū zài zhuōzi shàng.	(书: shū) Books on the table.
书巳出版。	 shū sì chūbǎn.	(书: shū) The book is out.
他的书	 tā de shū	(书: shū) his book
你的书包丢了？	 nǐ de shūbāo diū le?	(书包: shūbāo) You lost your bag?
你很了解中国。	 nǐ hěn liǎojiě zhōngguó.	(了解: liǎojiě) You really understand China.
这种事最麻烦。	 zhèzhǒng shì zuì máfan.	(事: shì) These kind of things are the most troublesome.
遇到事情，不要着急。	 yùdào shìqing, bú yào zháojí.	(事情: shìqíng) Something happens, do not worry.
十减二等如八。	 shí jiǎn èrděng rú bā.	(二等: èrděng) Subtract two from ten and you have eight.
我姓于。	 wǒ xìng yú.	(于: yú) My last name is Yu.
那晚多云。	 nà wǎn duōyún.	(云: yún) It was cloudy that night.
天上的云越来越多。	 tiānshàng de yún yuèláiyuè duō.	(云: yún) The clouds more and more.
天上的云彩。	 tiānshàng de yúncai.	(云彩: yúncai) The clouds above.
中国是亚洲国家。	 zhōngguó shì yàzhōu guójiā.	(亚洲: yàzhōu) China is the Asian country.
他想喝些冷饮。	 tā xiǎng hē xiē lěngyǐn.	(些: xiē) He wants something cold to drink.
他吃了些沙。	 tā chī le xiē shā.	(些: xiē) He ate some sand.
问我简单些的。	 wèn wǒ jiǎndān xiē de.	(些: xiē) Ask me something easier.
我买了些苹果。	 wǒ mǎi le xiē píngguǒ.	(些: xiē) I bought some apples.
我想买些靴子。	 wǒ xiǎng mǎi xiē xuēzi.	(些: xiē) I would like to purchase some boots.
宝宝，亲一下爸爸。	 bǎobǎo, qīn yíxià bàba.	(亲: qīn) Baby, give your dad a kiss.
我亲爱的妈妈。	 wǒ qīn'ài de māma.	(亲爱: qīn'ài) My dear mother.
李医生今年40岁。	 lǐ yīshēng jīnnián 40 suì.	(今年: jīnnián) Dr. Li 40 years old this year.
今年夏天太热了。	 jīnnián xiàtiān tài rè le.	(今年: jīnnián) This summer too hot.
我今年要学中文。	 wǒ jīnnián yào xué zhōngwén.	(今年: jīnnián) I am planning to learn Chinese this year.
今晚的月亮真圆！	 jīnwǎn de yuèliang zhēn yuán!	(今晚: jīnwǎn) Roundness of the moon tonight!
我今晚给你打电话。	 wǒ jīnwǎn gěi nǐ dǎ diànhuà.	(今晚: jīnwǎn) I'll ring you up tonight.
她做事十分仔细。	 tā zuò shì shífēn zǐxì.	(仔细: zǐxì) She did things very carefully.
你要现在付钱。	 nǐ yào xiànzài fùqián.	(付: fù) You need to pay now.
购物可以在网上付款。	 gòuwù kěyǐ zài wǎngshàng fùkuǎn.	(付款: fùkuǎn) Shopping can pay online.
水果以苹果为最佳。	 shuǐguǒ yǐ píngguǒ wèi zuìjiā.	(以: yǐ) Apples are the best fruit.
我以前不喜欢他。	 wǒ yǐqián bù xǐhuan tā.	(以前: yǐqián) Before, I didn't like him.
我以前不喜欢电影。	 wǒ yǐqián bù xǐhuan diànyǐng.	(以前: yǐqián) Before, I didn't like movies.
Ken中午以前会在家。	 kèi yì ēn zhōngwǔ yǐqián huì zài jiā.	(以前: yǐqián) Ken will be at home until noon.
我以前住在上海。	 wǒ yǐqián zhù zài shànghǎi.	(以前: yǐqián) Before, I lived in Shanghai.
以前她很喜欢笑。	 yǐqián tā hěn xǐhuan xiào.	(以前: yǐqián) Before, she really liked laughing.
她以前很喜欢笑。	 tā yǐqián hěn xǐhuan xiào.	(以前: yǐqián) Before, she really liked laughing.
我以前很快乐。	 wǒ yǐqián hěn kuàilè.	(以前: yǐqián) Before, I was very happy.
我以前很爱学习。	 wǒ yǐqián hěn ài xuéxí.	(以前: yǐqián) Before, I really loved studying.
以前我不喜欢他。	 yǐqián wǒ bù xǐhuan tā.	(以前: yǐqián) Before, I didn't like him.
以前我不喜欢电影。	 yǐqián wǒ bù xǐhuan diànyǐng.	(以前: yǐqián) Before, I didn't like movies.
以前我住在上海。	 yǐqián wǒ zhù zài shànghǎi.	(以前: yǐqián) Before, I lived in Shanghai.
以前我很快乐。	 yǐqián wǒ hěn kuàilè.	(以前: yǐqián) Before, I was very happy.
以前我很爱学习。	 yǐqián wǒ hěn ài xuéxí.	(以前: yǐqián) Before, I really loved studying.
以前我是一个老师。	 yǐqián wǒ shì yíge lǎoshī.	(以前: yǐqián) Before, I was a teacher.
以前我没有钱。	 yǐqián wǒ méiyǒu qián.	(以前: yǐqián) Before, I didn't have any money.
以前我们经常聊天。	 yǐqián wǒmen jīngcháng liáotiān.	(以前: yǐqián) Before, we often talked together.
我以前是一个老师。	 wǒ yǐqián shì yíge lǎoshī.	(以前: yǐqián) Before, I was a teacher.
我以前没有钱。	 wǒ yǐqián méiyǒu qián.	(以前: yǐqián) Before, I didn't have any money.
我们以前经常聊天。	 wǒmen yǐqián jīngcháng liáotiān.	(以前: yǐqián) Before, we often talked together.
我以后会联系你。	 wǒ yǐhòu huì liánxì nǐ.	(以后: yǐhòu) In the future I will contact you.
喝酒以后别开车。	 hējiǔ yǐhòu bié kāichē.	(以后: yǐhòu) After drinking alcohol, don't drive.
十八岁以后可以喝酒。	 shíbā suì yǐhòu kěyǐ hējiǔ.	(以后: yǐhòu) After you are 18 years old you may drink alcohol.
看完以后告诉我。	 kàn wán yǐhòu gàosu wǒ.	(以后: yǐhòu) Tell me when you have finished watching.
这件衣服很好看。	 zhè jiàn yīfu hěn hǎokàn.	(件: jiàn) This piece of clothing looks good.
我按时完成了任务。	 wǒ ànshí wánchéng le rènwu.	(任务: rènwù) I completed the mission.
我们提前完成了任务。	 wǒmen tíqián wánchéng le rènwu.	(任务: rènwù) We are ahead of schedule.
任务完成百分之八十了。	 rènwu wánchéng bǎifēnzhī bāshí le.	(任务: rènwù) Eighty percent of the task is completed.
我要两份鸡肉。	 wǒ yào liǎng fèn jīròu.	(份: fèn) I want two pieces of Chicken.
我明天下午休假。	 wǒ míngtiān xiàwǔ xiūjià	(休假: xiūjià) I am taking tomorrow afternoon off.
休息10分钟。	 xiūxī0 fēnzhōng。 	(休息: xiūxí) Let's take a 10-minute break.
请不要影响别人休息。	 qǐng bùyào yǐngxiǎng biéren xiūxi。 	(休息: xiūxí) Please do not influence others to rest.
我要休息一下。	 wǒ yào xiūxi yīxià。 	(休息: xiūxí) We need to rest for a while.
休息一下吧。	 xiūxi yīxià ba。 	(休息: xiūxí) Take a break.
我想休息几分钟。	 wǒ xiǎng xiūxi jǐ fēnzhōng。 	(休息: xiūxí) I want to rest a few minutes.
他会考上大学。	 tā huì kǎoshàng dàxué。 	(会考: huìkǎo) He will test into college.
我们下午有个会议。	 wǒmen xiàwǔ yǒu gè huìyì。 	(会议: huìyì) We have a meeting in the afternoon.
会议两点钟举行。	 huìyì liǎng diǎnzhōng jǔxíng。 	(会议: huìyì) Meeting held two o'clock.
会议准时开始了。	 huìyì zhǔnshí kāishǐ le。 	(会议: huìyì) Meeting started on time.
会议马上就要结束了。	 huìyì mǎshàng jiùyào jiéshù le。 	(会议: huìyì) Conference coming to an end.
铁能传热。	 tiě néng chuánrè。 	(传热: chuánrè) Iron transmits heat.
我现在很伤心。	 wǒ xiànzài hěn shāngxīn。 	(伤心: shāngxīn) Now, I am very sad.
海伦十七岁。	 Hǎilún shíqī suì。 	(伦: lún) Helen is seventeen years old.
但我没钱。	 dàn wǒ méi qián。 	(但: dàn) But I don't have any money.
我要打电话订位子。	 wǒ yào dǎdiànhuà dìngwèi zǐ。 	(位子: wèizi) I want to call to make the reservation.
你住哪里？	 nǐ zhù nǎlǐ？ 	(住: zhù) Where do you live?
住在上海非常方便。	 zhù zài Shàng Hǎi fēicháng fāngbiàn。 	(住: zhù) It is very convenient to live in Shanghai.
我住在上海。	 wǒ zhù zài Shàng Hǎi。 	(住: zhù) I live in Shanghai.
以前我住在上海。	 yǐqián wǒ zhù zài Shàng Hǎi。 	(住: zhù) Before, I lived in Shanghai.
我以前住在上海。	 wǒ yǐqián zhù zài Shàng Hǎi。 	(住: zhù) Before, I lived in Shanghai.
我住在北京。	 wǒ zhù zài Běijīng。 	(住: zhù) I live in Beijing.
我奶奶住在北京。	 wǒ nǎinai zhù zài Běijīng。 	(住: zhù) My grandmother lived in Beijing.
你住在哪儿？	 nǐ zhù zàinǎr？ 	(住: zhù) Where do you live?
您住在哪里？	 nín zhù zài nǎlǐ？ 	(住: zhù) Where do you live?
你住在哪里？	 nǐ zhù zài nǎlǐ？ 	(住: zhù) Where do you live?
她住在附近。	 tā zhù zài fùjìn。 	(住: zhù) She lives nearby.
我住这儿。	 wǒ zhù zhèr。 	(住: zhù) I live here.
你住这里吗?。	 nǐ zhù zhèlǐ ma?。 	(住: zhù) Do you live here?
我们非常重视体育锻炼。	 wǒmen fēicháng zhòngshì tǐyùduànliàn。 	(体育: tǐyù) We attach great importance to physical exercise.
我很喜欢体育运动。	 wǒ hěn xǐhuan tǐyùyùndòng。 	(体育运动: tǐyùyùndòng) I love sports.
你何时将回日本?。	 nǐ héshí jiāng huí Rìběn?。 	(何时: héshí) When will you go back to Japan?
我每天做作业。	 wǒ měitiān zuò zuòyè。 	(作业: zuòyè) I do my homework every day.
你怎么没写作业？	 nǐ zěnme méi xiě zuòyè？ 	(作业: zuòyè) Why haven't you done your homework?
作业你写了吗？	 zuòyè nǐ xiě le ma？ 	(作业: zuòyè) Did you do homework?
例句词	 lìjù cí 	(例: lì) Examples of Words
已经很便宜了。	 yǐjīng hěn piányi le。 	(便宜: piányí) It is already very cheap.
人们应该保护环境。	 rénmen yīnggāi bǎohù huánjìng。 	(保护: bǎohù) People should protect the environment.
妈妈很注意保护皮肤。	 māma hěn zhùyì bǎohù pífū。 	(保护: bǎohù) Mom very careful to protect the skin.
我们需要保护自然环境。	 wǒmen xūyào bǎohù zìrán huánjìng。 	(保护: bǎohù) We need to protect the natural environment.
收到一个信号。	 shōudào yī gè xìnhào。 	(信号: xìnhào) Catch a signal.
没有视频信号。	 méiyǒu shìpín xìnhào。 	(信号: xìnhào) There is no video signal.
红旗是危险的信号。	 hóngqí shì wēixiǎn de xìnhào。 	(信号: xìnhào) A red flag is a sign of danger.
我们俩是好朋友。	 wǒmen liǎ shì hǎopéngyou。 	(俩: liǎ) We both are good friends.
一个假名字。	 yī gè jiǎ míngzi。 	(假: jiǎ) An assumed name.
这只是个假设。	 zhè zhǐshì gè jiǎshè。 	(假设: jiǎshè) This is just a hypothesis.
这样做，对吗？	 zhèyàng zuò， duì ma？ 	(做: zuò) Like this, right?
尽早做。	 jǐnzǎo zuò。 	(做: zuò) Do it as soon as possible.
现在就做。	 xiànzài jiù zuò。 	(做: zuò) Do it now.
现在就做。	 xiànzài jiù zuò。 	(做: zuò) Do it now.
让我去做。	 ràng wǒ qù zuò。 	(做: zuò) Let me do that.
三明治很难做。	 sānmíngzhì hěn nán zuò。 	(做: zuò) Sandwiches are hard to make.
三明治很好做。	 sānmíngzhì hěn hǎo zuò。 	(做: zuò) Sandwiches are easy to make.
你想怎么做？	 nǐ xiǎng zěnme zuò？ 	(做: zuò) How do you do that?
中国菜怎么做？	 Zhōngguócài zěnme zuò？ 	(做: zuò) How do you cook Chinese food?
你会做三明治吗？	 nǐ huì zuò sānmíngzhì ma？ 	(做: zuò) Can you make a sandwich?
她会做中国菜。	 tā huì zuò Zhōngguócài。 	(做: zuò) She can cook Chinese food.
我要做中国菜。	 wǒ yào zuò Zhōngguócài。 	(做: zuò) I want to make Chinese food.
他做了一个蛋糕。	 tā zuò le yī gè dàngāo。 	(做: zuò) He made a cake.
你做了吗？	 nǐ zuò le ma？ 	(做: zuò) Did you make it?
你做什么？	 nǐ zuò shénme？ 	(做: zuò) What do you make?
你做什么？	 nǐ zuò shénme？ 	(做: zuò) What do you make?
你能做什么？	 nǐ néng zuò shénme？ 	(做: zuò) What can you do?
你周三要做什么？	 nǐ Zhōusān yào zuò shénme？ 	(做: zuò) What are you doing on Wednesday?
你们刚才做什么了？	 nǐmen gāngcái zuò shénme le？ 	(做: zuò) What are you doing right now?
我每天做作业。	 wǒ měitiān zuò zuòyè。 	(做: zuò) I do my homework every day.
这样做只是浪费时间。	 zhèyàng zuò zhǐshì làngfèi shíjiān。 	(做: zuò) This is just a waste of time.
做咖啡的男人	 zuò kāfēi de nánrén 	(做: zuò) The man that makes coffee.
我在商场做售货员。	 wǒ zài shāngchǎng zuò shòuhuòyuán。 	(做: zuò) I do salesman at the mall.
您下午做啥呢？	 nín xiàwǔ zuò shá ne？ 	(做: zuò) So what will you do in the afternoon?
这样做多不方便！	 zhèyàng zuò duō bùfāngbiàn！ 	(做: zuò) This is so inconvenient!
我今天要做完。	 wǒ jīntiān yào zuòwán。 	(做: zuò) I'm going to finish doing it today.
我们已经做完了。	 wǒmen yǐjīng zuò wánle。 	(做: zuò) We have already finished it.
工作差不多做完了。	 gōngzuò chàbuduō zuò wánle。 	(做: zuò) Work is almost over.
我已经做完了。	 wǒ yǐjīng zuò wánle。 	(做: zuò) I already finished it.
做得不好	 zuò dé bùhǎo 	(做: zuò) Do poorly
做得好(Impliesanaction)	zuò dé hǎoImpliesanaction	(做: zuò) )
我在饭馆做服务员。	 wǒ zài fànguǎn zuò fúwùyuán。 	(做: zuò) I was a waitress at the restaurant.
我会做的。	 wǒ huì zuò de。 	(做: zuò) I will do it.
我做的饭	 wǒ zuò de fàn 	(做: zuò) The food that I cook(ed).
你做过没？	 nǐ zuò guò méi？ 	(做: zuò) Have you ever done it?
她做事十分仔细。	 tā zuòshì shífēn zǐxì。 	(做事: zuòshì) She did things very carefully.
他做事总是那么慢。	 tā zuòshì zǒngshì nàme màn。 	(做事: zuòshì) He always does things so slow.
他已经做出了决定。	 tā yǐjīng zuòchū le juédìng。 	(做出: zuòchū) He has made a decision.
我们需要自己做出选择。	 wǒmen xūyào zìjǐ zuòchū xuǎnzé。 	(做出: zuòchū) We need to make their own choices.
我会做饭。	 wǒ huì zuòfàn。 	(做饭: zuòfàn) I can cook food.
我不会做饭。	 wǒ bùhuì zuòfàn。 	(做饭: zuòfàn) I can't cook food.
我太太没有做饭。	 wǒ tàitai méiyǒu zuòfàn。 	(做饭: zuòfàn) My wife didn't cook.
我太太没做饭。	 wǒ tàitai méi zuòfàn。 	(做饭: zuòfàn) My wife didn't cook.
我妈妈正在做饭。	 wǒ māma zhèngzài zuòfàn。 	(做饭: zuòfàn) My mom is cooking right now.
怎么做饭？	 zěnme zuòfàn？ 	(做饭: zuòfàn) How do you cook?
汽车停了下来。	 qìchē tíng le xiàlai。 	(停: tíng) Cars stopped.
爸爸的身体特别健康。	 bàba de shēntǐ tèbié jiànkāng。 	(健康: jiànkāng) Dad's body especially health.
吃这种东西不健康。	 chī zhèzhǒng dōngxi bù jiànkāng。 	(健康: jiànkāng) Eating this stuff is not healthy.
你傻啊？	 nǐ shǎ ā？ 	(傻: shǎ) What are you, stupid?
我像你一样。	 wǒ xiàng nǐ yīyàng。 	(像: xiàng) I am like you.
他是我兄弟。	 tā shì wǒ xiōngdì。 	(兄弟: xiōngdì) He is my brother.
他有三名兄长。	 tā yǒu sān míng xiōngzhǎng。 	(兄长: xiōngzhǎng) He has three brothers.
请先别挂电话。	 qǐng xiān bié guà diànhuà。 	(先: xiān) Please do not hang up.
先谢谢了。	 xiān xièxie le。 	(先: xiān) Thanks in advance.
你也认识王先生？	 nǐ yě rènshi wáng xiānsheng？ 	(先生: xiānshēng) You also know, Mr. Wang?
格林先生是历史老师。	 Gélín xiānsheng shì lìshǐ lǎoshī。 	(先生: xiānshēng) Mr. Green is a history teacher.
先生的学问博大精深。	 xiānsheng de xuéwèn bódàjīngshēn。 	(先生: xiānshēng) The teacher had both extensive knowledge and profound scholarship.
免费的。	 miǎnfèi de。 	(免费: miǎnfèi) It's for free.
狗追兔子。	 gǒu zhuī tùzi。 	(兔子: tùzǐ) The dog chased the rabbit.
现在是早上八时。	 xiànzài shì zǎoshang bā shí。 	(八时: bāshí) It's eight o'clock in the morning.
老公刚回家。	 lǎogong gāng huíjiā。 	(公: gōng) The husband just came home.
公共场所禁止抽烟。	 gōnggòng chǎngsuǒ jìnzhǐ chōuyān。 	(公共场所: gōnggòngchǎngsuǒ) Ban smoking in public places.
我去公司。	 wǒ qù gōngsī。 	(公司: gōngsī) I'm going to the office.
我要去公司。	 wǒ yào qù gōngsī。 	(公司: gōngsī) I will go to the office.
他刚来我们公司。	 tā gāng lái wǒmen gōngsī。 	(公司: gōngsī) He just came to our office.
老板今天不来公司。	 lǎobǎn jīntiān bù lái gōngsī。 	(公司: gōngsī) The boss won't come to work today.
我在一个公司上班。	 wǒ zài yī gè gōngsī shàngbān。 	(公司: gōngsī) I work in a company.
我们公司也是。	 wǒmen gōngsī yě shì。 	(公司: gōngsī) Our company is too. / Our company too.
我来公司了。	 wǒ lái gōngsī le。 	(公司: gōngsī) I arrived at the office.
你到公司了吗？	 nǐ dào gōngsī le ma？ 	(公司: gōngsī) Did you get to the company?
你在公司吗？	 nǐ zài gōngsī ma？ 	(公司: gōngsī) Are you at the office?
我们公司在西安。	 wǒmen gōngsī zài Xī'ān。 	(公司: gōngsī) Our company is in Xi'an.
你们公司多大？	 nǐmen gōngsī duōdà？ 	(公司: gōngsī) How big is your company?
我在这个公司工作。	 wǒ zài zhège gōngsī gōngzuò。 	(公司: gōngsī) I work at this company.
我家离公司很近。	 wǒ jiā lí gōngsī hěn jìn。 	(公司: gōngsī) My house is close to my office.
我家离公司很远。	 wǒ jiā lí gōngsī hěn yuǎn。 	(公司: gōngsī) My home is far away from the company.
我家距离公司很远。	 wǒ jiā jùlí gōngsī hěn yuǎn。 	(公司: gōngsī) My company is very far away from home.
我们公司没有电脑。	 wǒmen gōngsī méiyǒu diànnǎo。 	(公司: gōngsī) Our company doesn't have computers.
公司的老板	 gōngsī de lǎobǎn 	(公司: gōngsī) the company's boss
我们公司还算好。	 wǒmen gōngsī hái suàn hǎo。 	(公司: gōngsī) Our office is fairly good.
我把电视关了。	 wǒ bǎ diànshì guān le。 	(关: guān) I put the TV off.
他关上了门。	 tā guānshàng le mén。 	(关上: guānshàng) He shut the door.
他从不关心别人。	 tā cóngbù guānxīn biéren。 	(关心: guānxīn) He never cares about others.
他从来不关心别人。	 tā cóngláibù guānxīn biéren。 	(关心: guānxīn) He never cares about others.
女人不太关心政治。	 nǚrén bù tài guānxīn zhèngzhì。 	(关心: guānxīn) Women are not too concerned about politics.
请把电视关掉。	 qǐng bǎ diànshì guāndiào。 	(关掉: guāndiào) Please turn off the television.
请关门。	 qǐng guānmén。 	(关门: guānmén) Please close the door.
商店周一关门。	 shāngdiàn Zhōuyī guānmén。 	(关门: guānmén) The store is closed Mondays.
银行下午5点关门。	 yínháng xiàwǔ5 diǎn guānmén。 	(关门: guānmén) 17:00 closed bank.
再等等吧。	 zài děngděng ba。 	(再: zài) Wait a little longer.
我走了，再见！	 wǒ zǒu le， zàijiàn！ 	(再见: zàijiàn) I go, bye!
我想说再见。	 wǒ xiǎng shuō zàijiàn。 	(再见: zàijiàn) I want to say goodbye.
我要他写。	 wǒ yào tā xiě。 	(写: xiě) I had him write it.
每隔一行写。	 měigé yīxíng xiě。 	(写: xiě) Write on every other line.
请用铅笔写。	 qǐng yòng qiānbǐ xiě。 	(写: xiě) Please write with a pencil.
请用钢笔写。	 qǐng yòng gāngbǐ xiě。 	(写: xiě) Please write with a pen.
不，我没写。	 bù， wǒ méi xiě。 	(写: xiě) No, I didn't write it.
这个汉字很难写。	 zhège hànzì hěn nán xiě。 	(写: xiě) This character is very difficult to write.
这个汉字很好写。	 zhège hànzì hěn hǎo xiě。 	(写: xiě) This Chinese character is easy to write.
写一下这个字。	 xiě yīxià zhège zì。 	(写: xiě) Please write down this character.
作业你写了吗？	 zuòyè nǐ xiě le ma？ 	(写: xiě) Did you do homework?
你怎么没写作业？	 nǐ zěnme méi xiě zuòyè？ 	(写: xiě) Why haven't you done your homework?
请把数字写清楚。	 qǐng bǎ shùzì xiě qīngchu。 	(写: xiě) Please write clearly digital.
安喜欢写诗。	 ān xǐhuan xiě shī。 	(写: xiě) Ann likes to write poems.
我喜欢写写东西。	 wǒ xǐhuan xiě xiě dōngxi。 	(写写: xiěxiě) I like to write a little bit.
北方的冬天很冷。	 běifāng de dōngtiān hěn lěng。 	(冬天: dōngtiān) Cold northern winter.
上海的冬天有点冷。	 Shàng Hǎi de dōngtiān yǒudiǎn lěng。 	(冬天: dōngtiān) Winter in Shanghai is a bit too cold.
我要冰的可乐。	 wǒ yào bīng de kělè。 	(冰: bīng) I want coke with ice.
冰的还是热的？	 bīng de háishi rè de？ 	(冰: bīng) Cold or hot?
吃不吃冰淇淋？	 chī bù chī bīngqílín？ 	(冰淇淋: bīngqílín) Do you eat ice cream or not?
冰箱里还有饮料吗？	 bīngxiāng lǐ háiyǒu yǐnliào ma？ 	(冰箱: bīngxiāng) Fridge there to drink?
他已经做出了决定。	 tā yǐjīng zuòchū le juédìng。 	(决定: juédìng) He has made a decision.
我们决定明天去爬山。	 wǒmen juédìng míngtiān qù páshān。 	(决定: juédìng) We decided to go hiking tomorrow.
我冷。	 wǒ lěng。 	(冷: lěng) I'm cold.
我冷。	 wǒ lěng。 	(冷: lěng) I'm cold.
非常冷。	 fēicháng lěng。 	(冷: lěng) It's very cold.
今天很冷。	 jīntiān hěn lěng。 	(冷: lěng) It's cold today.
天很冷。	 tiān hěn lěng。 	(冷: lěng) It's cold.
今天很冷。	 jīntiān hěn lěng。 	(冷: lěng) It's cold today.
今天不冷。	 jīntiān bù lěng。 	(冷: lěng) Today it isn't cold.
今天天气比较冷。	 jīntiān tiānqì bǐjiào lěng。 	(冷: lěng) Today the weather is cold.
上海没有北京冷。	 Shàng Hǎi méiyǒu Běijīng lěng。 	(冷: lěng) Shanghai is not as cold as Beijing.
纽约比上海冷。	 Niǔyuē bǐ Shàng Hǎi lěng。 	(冷: lěng) New York is colder than Shanghai.
北方的冬天很冷。	 běifāng de dōngtiān hěn lěng。 	(冷: lěng) Cold northern winter.
我感觉今天有点儿冷。	 wǒ gǎnjué jīntiān yǒudiǎnr lěng。 	(冷: lěng) I feel a little cold today.
上海的冬天有点冷。	 Shàng Hǎi de dōngtiān yǒudiǎn lěng。 	(冷: lěng) Winter in Shanghai is a bit too cold.
外面多冷？	 wàimiàn duō lěng？ 	(冷: lěng) How cold is it outside?
今天怎么不冷？	 jīntiān zěnme bù lěng？ 	(冷: lěng) How is it not cold today?
昨天怎么那么冷？	 zuótiān zěnme nàme lěng？ 	(冷: lěng) How could it be so cold yesterday?
天气冷了。	 tiānqì lěng le。 	(冷: lěng) The weather is getting cold.
今天太冷了。	 jīntiān tài lěng le。 	(冷: lěng) Cold today.
多么冷啊!。	 duōme lěng ā!。 	(冷: lěng) How cold it is!
冷死了。	 lěng sǐ le。 	(冷: lěng) It's so/terribly cold!
今天~冷的。够	 jīntiān~ lěng de。 gòu 	(冷: lěng) Today ~ cold. Enough
我想喝冷饮。	 wǒ xiǎng hē lěngyǐn。 	(冷饮: lěngyǐn) I want to drink something cold.
他想喝些冷饮。	 tā xiǎng hē xiē lěngyǐn。 	(冷饮: lěngyǐn) He wants something cold to drink.
我准备星期日去北京。	 wǒ zhǔnbèi Xīngqīrì qù Běijīng。 	(准备: zhǔnbèi) I am ready to go to Beijing Sunday.
会议准时开始了。	 huìyì zhǔnshí kāishǐ le。 	(准时: zhǔnshí) Meeting started on time.
这班飞机准时起飞。	 zhè bān fēijī zhǔnshí qǐfēi。 	(准时: zhǔnshí) The airplane took off on time.
你的答案非常准确。	 nǐ de dá'àn fēicháng zhǔnquè。 	(准确: zhǔnquè) Your answer is very accurate.
秋天的天气很凉快。	 qiūtiān de tiānqì hěn liángkuai。 	(凉快: liángkuai) Autumn weather is very cool.
天气挺凉爽。	 tiānqì tǐng liángshuǎng。 	(凉爽: liángshuǎng) The weather is quite pleasantly cool.
十减二等如八。	 shí jiǎn èrděng rú bā。 	(减: jiǎn) Subtract two from ten and you have eight.
九减六等于多少？	 jiǔ jiǎn liù děngyú duōshao？ 	(减: jiǎn) How many is nine minus six?
顾客减少了三分之一。	 gùkè jiǎnshǎo le sānfēnzhīyī。 	(减少: jiǎnshǎo) Customers decreased by a third.
我每天跑步减肥。	 wǒ měitiān pǎobù jiǎnféi。 	(减肥: jiǎnféi) I run every day to lose weight.
书巳出版。	 shū sì chūbǎn。 	(出版: chūbǎn) The book is out.
地铁还是出租车？	 dìtiě háishi chūzūchē？ 	(出租车: chūzūchē) Subway or taxi?
出租车到了。	 chūzūchē dàoliǎo。 	(出租车: chūzūchē) The taxi has arrived.
我们坐出租车去火车站。	 wǒmen zuò chūzūchē qù huǒchēzhàn。 	(出租车: chūzūchē) We take a taxi to the train station.
附近有出租车吗？	 fùjìn yǒu chūzūchē ma？ 	(出租车: chūzūchē) Are there taxis around here?
我们刚下班。	 wǒmen gāng xiàbān。 	(刚: gāng) We just got off work.
他刚出去。	 tā gāng chūqù。 	(刚: gāng) He just went out.
我刚到家。	 wǒ gāng dàojiā。 	(刚: gāng) I just got home.
我刚吃完饭。	 wǒ gāng chīwán fàn。 	(刚: gāng) I just finished eating.
老公刚回家。	 lǎogong gāng huíjiā。 	(刚: gāng) The husband just came home.
他刚工作。	 tā gāng gōngzuò。 	(刚: gāng) He just started working.
他刚工作一年。	 tā gāng gōngzuò yī nián。 	(刚: gāng) He just worked a year.
他刚来我们公司。	 tā gāng lái wǒmen gōngsī。 	(刚: gāng) He just came to our office.
我刚知道。	 wǒ gāng zhīdào。 	(刚: gāng) I just found out.
他刚离开家。	 tā gāng líkāi jiā。 	(刚: gāng) He has just left home.
我们刚认识一个月。	 wǒmen gāng rènshi yī gè yuè。 	(刚: gāng) We just knew each other for a month.
她们刚走。	 tāmen gāng zǒu。 	(刚: gāng) They just left.
他刚走十分钟。	 tā gāng zǒu shífēn zhōng。 	(刚: gāng) He just left ten minutes ago.
宝宝刚起床。	 bǎobǎo gāng qǐchuáng。 	(刚: gāng) The baby just woke up.
刚才你去哪儿了？	 gāngcái nǐ qù nǎr le？ 	(刚才: gāngcái) Just now where did you go?
你们刚才做什么了？	 nǐmen gāngcái zuò shénme le？ 	(刚才: gāngcái) What are you doing right now?
刚才我去洗手间了。	 gāngcái wǒ qù xǐshǒujiān le。 	(刚才: gāngcái) Just now I went to the washroom.
刚才我开会了。	 gāngcái wǒ kāihuì le。 	(刚才: gāngcái) I have a meeting just now.
宝宝刚才笑了。	 bǎobǎo gāngcái xiào le。 	(刚才: gāngcái) The baby just now laughed.
你刚才说什么了？	 nǐ gāngcái shuō shénme le？ 	(刚才: gāngcái) What did you just say?
你的判断完全正确。	 nǐ de pànduàn wánquán zhèngquè。 	(判断: pànduàn) Your judgment is correct.
请别发火。	 qǐng bié fāhuǒ。 	(别: bié) Please do not get angry.
别听她的。	 bié tīng tā de。 	(别: bié) Don't listen to her.
别听她的。	 bié tīng tā de。 	(别: bié) Don't listen to her.
别哭。	 bié kū。 	(别: bié) Don't cry.
别喝太多酒。	 bié hē tài duō jiǔ。 	(别: bié) Don't drink too much alcohol.
别坐在地上。	 bié zuò zài dìshang。 	(别: bié) Don't sit on the floor.
喝酒以后别开车。	 hējiǔ yǐhòu bié kāichē。 	(别: bié) After drinking alcohol, don't drive.
别忘记刷牙。	 bié wàngjì shuāyá。 	(别: bié) Don't forget to brush your teeth.
别总是不高兴。	 bié zǒngshì bù gāoxìng。 	(别: bié) Don't always be unhappy.
请先别挂电话。	 qǐng xiān bié guà diànhuà。 	(别: bié) Please do not hang up.
别生气！	 bié shēngqì！ 	(别: bié) Don't get mad!
别看了，睡觉！	 bié kàn le， shuìjiào！ 	(别: bié) Stop watching. Go to sleep!
别笑！	 bié xiào！ 	(别: bié) Don't laugh!
你别胡说！	 nǐ bié húshuō！ 	(别: bié) Don't speak nonsense!
别说话！	 bié shuōhuà！ 	(别: bié) Don't speak!
别走。	 bié zǒu。 	(别: bié) Don't go.
小心，别跑！	 xiǎoxīn， bié pǎo！ 	(别: bié) Be careful, don't run!
别跟我说英文。	 bié gēn wǒ shuō Yīngwén。 	(别: bié) Don't speak English with me.
他从不关心别人。	 tā cóngbù guānxīn biéren。 	(别人: biérén) He never cares about others.
他很愿意帮助别人。	 tā hěn yuànyì bāngzhù biéren。 	(别人: biérén) He was very willing to help others.
他从来不关心别人。	 tā cóngláibù guānxīn biéren。 	(别人: biérén) He never cares about others.
请不要影响别人休息。	 qǐng bùyào yǐngxiǎng biéren xiūxi。 	(别人: biérén) Please do not influence others to rest.
上海比别的城市方便。	 Shàng Hǎi bǐ biéde chéngshì fāngbiàn。 	(别的: biéde) Shanghai is more convenient than other cities.
我到上海。	 wǒ dào Shàng Hǎi。 	(到: dào) I arrived at Shanghai.
我们到了！	 wǒmen dàoliǎo！ 	(到: dào) Here we are!
我们到了。	 wǒmen dàoliǎo。 	(到: dào) We're here!
出租车到了。	 chūzūchē dàoliǎo。 	(到: dào) The taxi has arrived.
我们快到了。	 wǒmen kuài dàoliǎo。 	(到: dào) We are about to arrive.
我们快要到了。	 wǒmen kuàiyào dàoliǎo。 	(到: dào) We will arrive soon.
玛丽到了医院。	 Mǎlì dàoliǎo yīyuàn。 	(到: dào) Mary arrived at the hospital.
到了吗？	 dàoliǎo ma？ 	(到: dào) There yet?
你到公司了吗？	 nǐ dào gōngsī le ma？ 	(到: dào) Did you get to the company?
我去到医院。	 wǒ qù dào yīyuàn。 	(到: dào) I went to the hospital.
你要到哪儿？	 nǐ yào dào nǎr？ 	(到: dào) Where are you going to?
我刚到家。	 wǒ gāng dàojiā。 	(到: dào) I just got home.
请问怎样打电话到日本？	 qǐngwèn zěnyàng dǎdiànhuà dào Rìběn？ 	(到: dào) How can I make a telephone call to Japan?
退到绳子后面。	 tuì dào shéngzi hòumian。 	(到: dào) Stand back from the rope.
我们到车子后面推车。	 wǒmen dào chēzi hòumian tuīchē。 	(到: dào) We got behind the car and pushed.
她七点钟到车站。	 tā qī diǎnzhōng dào chēzhàn。 	(到: dào) She got to the station at seven.
她应该中午到那里。	 tā yīnggāi zhōngwǔ dào nàli。 	(到: dào) She should be there at noon.
他们已经到酒吧了。	 tāmen yǐjīng dào jiǔbā le。 	(到: dào) They already got to the bar.
我刷过牙了。	 wǒ shuā guò yá le。 	(刷: shuā) I have brushed my teeth
别忘记刷牙。	 bié wàngjì shuāyá。 	(刷牙: shuāyá) Don't forget to brush your teeth.
睡觉前要刷牙。	 shuìjiào qián yào shuāyá。 	(刷牙: shuāyá) To brush your teeth before going to bed.
十点三刻	 shí diǎn sān kè 	(刻: kè) 0,447916666666667
两点三刻	 liǎng diǎn sān kè 	(刻: kè) 0,114583333333333
四点三刻	 sì diǎn sān kè 	(刻: kè) 0,197916666666667
睡觉前要刷牙。	 shuìjiào qián yào shuāyá。 	(前: qián) To brush your teeth before going to bed.
他七年前来日本。	 tā qī niánqián láirì běn。 	(前来: qiánlái) He came to Japan seven years ago.
我两年前来日本。	 wǒ liǎng niánqián láirì běn。 	(前来: qiánlái) I came to Japan two years ago.
他两年前来日本。	 tā liǎng niánqián láirì běn。 	(前来: qiánlái) He came to Japan two years ago.
他七年前来日本。	 tā qī niánqián láirì běn。 	(前来: qiánlái) He came to Japan seven years ago.
零在一前面。	 líng zài yī qiánmiàn。 	(前面: qiánmiàn) Zero comes before one.
把椅子放在桌子前面。	 bǎ yǐzi fàng zài zhuōzi qiánmiàn。 	(前面: qiánmiàn) Put the chair in front of the desk.
车站前面有个邮局。	 chēzhàn qiánmiàn yǒu gè yóujú。 	(前面: qiánmiàn) There is a post office in front of the station.
前面有危险。	 qiánmiàn yǒu wēixiǎn。 	(前面: qiánmiàn) Danger ahead.
这是个副词。	 zhè shì gè fùcí。 	(副: fù) This is an adverb.
这药没有副作用。	 zhè yào méiyǒu fùzuòyòng。 	(副作用: fùzuòyòng) This medicine does not have side effects.
我没办法。	 wǒ méibànfǎ。 	(办法: bànfǎ) I don't have a way.
我没有办法。	 wǒ méiyǒu bànfǎ。 	(办法: bànfǎ) I don't have a way.
我们没办法出去。	 wǒmen méibànfǎ chūqù。 	(办法: bànfǎ) We have no way of going out.
他没办法去中国。	 tā méibànfǎ qù Zhōngguó。 	(办法: bànfǎ) He has no way to go to China.
我没办法帮你。	 wǒ méibànfǎ bāng nǐ。 	(办法: bànfǎ) I have no way to help you.
一加二等于三。	 yī jiā èr děngyú sān。 	(加: jiā) One plus two is equal to three.
天天加班，累啊！	 tiāntiān jiābān， lèi ā！ 	(加班: jiābān) Working overtime every day is so tiring!
饲养员正在喂动物。	 sìyǎngyuán zhèngzài wèi dòngwù。 	(动物: dòngwù) The keeper is feeding the animals.
学生们学习很努力。	 xuésheng men xuéxí hěn nǔlì。 	(努力: nǔlì) The students study very hard.
鲍勃很高兴。	 bào bó hěn gāoxìng。 	(勃: bó) Bob was very happy.
他在医院。	 tā zài yīyuàn。 	(医院: yīyuàn) He is in hospital.
我去到医院。	 wǒ qù dào yīyuàn。 	(医院: yīyuàn) I went to the hospital.
玛丽到了医院。	 Mǎlì dàoliǎo yīyuàn。 	(医院: yīyuàn) Mary arrived at the hospital.
这是一个大医院。	 zhè shì yī gè dà yīyuàn。 	(医院: yīyuàn) This is a big hospital.
我在医院工作。	 wǒ zài yīyuàn gōngzuò。 	(医院: yīyuàn) I work in a hospital.
我在医院工作。	 wǒ zài yīyuàn gōngzuò。 	(医院: yīyuàn) I work in a hospital.
他想在医院工作。	 tā xiǎng zài yīyuàn gōngzuò。 	(医院: yīyuàn) He wants to work in a hospital.
我丈夫在医院工作。	 wǒ zhàngfu zài yīyuàn gōngzuò。 	(医院: yīyuàn) My husband works in a hospital.
药局在医院附近。	 yàojú zài yīyuàn fùjìn。 	(医院: yīyuàn) The pharmacy is near the hospital.
现在是十时正。	 xiànzài shì shí shí zhèng。 	(十时: shíshí) It's ten o'clock sharp.
你来南京路吧。	 nǐ lái Nánjīnglù ba。 	(南京路: nánjīnglù) Come to Nanjing road.
我家在火车站的南边。	 wǒ jiā zài huǒchēzhàn de nánbian。 	(南边: nánbian) My home in the south train station.
先生的学问博大精深。	 xiānsheng de xuéwèn bódàjīngshēn。 	(博大精深: bódàjīngshēn) The teacher had both extensive knowledge and profound scholarship.
本题占五十分。	 běntí zhàn wǔshí fēn。 	(占: zhàn) This question counts for 50 points.
请问，卫生间在哪儿？	 qǐngwèn， wèishēngjiān zàinǎr？ 	(卫生间: wèishēngjiān) Excuse me, where is the bathroom?
前面有危险。	 qiánmiàn yǒu wēixiǎn。 	(危险: wéixiǎn) Danger ahead.
红旗是危险的信号。	 hóngqí shì wēixiǎn de xìnhào。 	(危险: wéixiǎn) A red flag is a sign of danger.
格林先生是历史老师。	 Gélín xiānsheng shì lìshǐ lǎoshī。 	(历史: lìshǐ) Mr. Green is a history teacher.
男厕所在一层。	 náncè suǒzài yīcéng。 	(厕所: cèsuǒ) The men's room on the first floor.
这本书非常厚。	 zhè běn shū fēicháng hòu。 	(厚: hòu) This book is very thick.
这本书太厚了。	 zhè běn shū tài hòu le。 	(厚: hòu) This book is too thick.
水果刀在厨房里。	 shuǐguǒdāo zài chúfáng lǐ。 	(厨房: chúfáng) Fruit knife in the kitchen.
去年我去了北京。	 qùnián wǒ qù le Běijīng。 	(去年: qùnián) Last year I went to Beijing.
他又丑又笨。	 tā yòu chǒu yòu bèn。 	(又: yòu) He is both ugly and stupid.
孩子又哭了起来。	 háizi yòu kū le qilai。 	(又: yòu) Children cried again.
他又高又帅。	 tā yòu gāo yòu shuài。 	(又: yòu) He is both tall and handsome.
她又聪明又漂亮。	 tā yòu cōngming yòu piàoliang。 	(又: yòu) She is both smart and beautiful。
老师不太友好。	 lǎoshī bù tài yǒuhǎo。 	(友好: yǒuhǎo) The teacher is not too friendly.
这个计划大家都反对。	 zhège jìhuà dàjiā dōu fǎnduì。 	(反对: fǎnduì) We are opposed to this plan.
请别发火。	 qǐng bié fāhuǒ。 	(发火: fāhuǒ) Please do not get angry.
我眼皮发热。	 wǒ yǎnpí fārè。 	(发热: fārè) My eyelid feels hot.
我爸爸变老了。	 wǒ bàba biàn lǎo le。 	(变: biàn) My father became old.
天气变阴了。	 tiānqì biàn yīn le。 	(变: biàn) The weather turned bad.
金字塔是古时候建造的。	 jīnzìtǎ shì gǔshíhou jiànzào de。 	(古时候: gǔshíhòu) The pyramids were built in ancient times.
例句词	 lìjù cí 	(句: jù) Examples of Words
这句话很难懂。	 zhè jù huà hěn nándǒng。 	(句: jù) This talk is hard to understand.
我要冰的可乐。	 wǒ yào bīng de kělè。 	(可乐: kělè) I want coke with ice.
他从没喝过可乐。	 tā cóngméi hē guò kělè。 	(可乐: kělè) He has never been drunk cola.
喝不喝可乐？	 hē bù hē kělè？ 	(可乐: kělè) Will you have some cola?
我喜欢可乐和茶。	 wǒ xǐhuan kělè hé chá。 	(可乐: kělè) I like cola and tea.
请说可以！	 qǐng shuō kěyǐ！ 	(可以: kěyǐ) Please say 'yes'!
那个学校还可以。	 nàge xuéxiào hái kěyǐ。 	(可以: kěyǐ) That school is so-so.
这里的菜还可以。	 zhèlǐ de cài hái kěyǐ。 	(可以: kěyǐ) The food here is so-so.
这里的菜还可以。	 zhèlǐ de cài hái kěyǐ。 	(可以: kěyǐ) (Said with the right expression)
星期六或者星期天都可以。	 Xīngqīliù huòzhě Xīngqītiān dōu kěyǐ。 	(可以: kěyǐ) Saturday or Sunday are both ok.
你可以十点来吗？	 nǐ kěyǐ shí diǎn lái ma？ 	(可以: kěyǐ) Can you come at 10 o'clock?
我们都可以去吗？	 wǒmen dōu kěyǐ qù ma？ 	(可以: kěyǐ) Can we all go?
现在可以吃饭吗？	 xiànzài kěyǐ chīfàn ma？ 	(可以: kěyǐ) Can we eat now?
现在不可以吃饭吗？	 xiànzài bùkěyǐ chīfàn ma？ 	(可以: kěyǐ) Can't I eat now?
三点钟可以吗？	 sān diǎnzhōng kěyǐ ma？ 	(可以: kěyǐ) Would three o'clock be all right?
我想应该可以吧。	 wǒ xiǎng yīnggāi kěyǐ ba。 	(可以: kěyǐ) I think it should be OK.
你可以告诉他。	 nǐ kěyǐ gàosu tā。 	(可以: kěyǐ) You can tell him.
你不可以告诉他。	 nǐ bùkěyǐ gàosu tā。 	(可以: kěyǐ) You can't tell him.
可以啊！	 kěyǐ ā！ 	(可以: kěyǐ) It's fine!
十八岁以后可以喝酒。	 shíbā suì yǐhòu kěyǐ hējiǔ。 	(可以: kěyǐ) After you are 18 years old you may drink alcohol.
购物可以在网上付款。	 gòuwù kěyǐ zài wǎngshàng fùkuǎn。 	(可以: kěyǐ) Shopping can pay online.
你可以坐船去上海。	 nǐ kěyǐ zuò chuán qù Shàng Hǎi。 	(可以: kěyǐ) You can boat to Shanghai.
我可以看这个吗？	 wǒ kěyǐ kàn zhège ma？ 	(可以: kěyǐ) May I see this?
小孩子不可以看这个。	 xiǎoháizi bùkěyǐ kàn zhège。 	(可以: kěyǐ) Young children can't watch this.
这里可以说话吗？	 zhèlǐ kěyǐ shuōhuà ma？ 	(可以: kěyǐ) Can I speak here?
这里不可以说话吗？	 zhèlǐ bùkěyǐ shuōhuà ma？ 	(可以: kěyǐ) Can't I talk here?
他可以跟我们来。	 tā kěyǐ gēn wǒmen lái。 	(可以: kěyǐ) He can come with us.
现在你不可以进来。	 xiànzài nǐ bùkěyǐ jìnlái。 	(可以: kěyǐ) You can't come in right now.
我可以进来吗？	 wǒ kěyǐ jìnlái ma？ 	(可以: kěyǐ) May I come in?
你不可以迟到。	 nǐ bùkěyǐ chídào。 	(可以: kěyǐ) You can't be late.
这是可怕一点儿。	 zhè shì kěpà yīdiǎnr。 	(可怕: kěpà) It's a little scary.
你的儿子真可爱。	 nǐ de érzi zhēn kě'ài。 	(可爱: kě'ài) Your son is so cute.
小猫太可爱了！	 xiǎomāo tài kě'ài le！ 	(可爱: kě'ài) The kitten is too cute! / The kitten is very cute!
可爱的宝宝	 kě'ài de bǎobǎo 	(可爱: kě'ài) A cute baby.
下午可能会下雪。	 xiàwǔ kěnéng huì xiàxuě。 	(可能: kěnéng) It may snow in the afternoon.
八台电脑	 bā tái diànnǎo 	(台: tái) eight computers
这台电视很重。	 zhè tái diànshì hěn zhòng。 	(台: tái) This television is very heavy.
他去了台湾。	 tā qù le Táiwān。 	(台湾: táiwān) He went to Taiwan.
我坐在你右边。	 wǒ zuò zài nǐ yòubian。 	(右边: yòubiān) I sit on your right side.
我们把西瓜吃光了。	 wǒmen bǎ xīguā chī guāng le。 	(吃光: chīguāng) We ate watermelon.
我要吃饭。	 wǒ yào chīfàn。 	(吃饭: chīfàn) I want to eat.
我们正在吃饭。	 wǒmen zhèngzài chīfàn。 	(吃饭: chīfàn) We're eating right now.
我想吃饭。	 wǒ xiǎng chīfàn。 	(吃饭: chīfàn) I want to eat meal.
我们一起吃饭。	 wǒmen yīqǐ chīfàn。 	(吃饭: chīfàn) Let's eat together.
我不想吃饭。	 wǒ bùxiǎng chīfàn。 	(吃饭: chīfàn) I wouldn't like to eat meal.
我要回家吃饭。	 wǒ yào huíjiā chīfàn。 	(吃饭: chīfàn) I want to go home and eat.
他想请我吃饭。	 tā xiǎng qǐng wǒ chīfàn。 	(吃饭: chīfàn) He wanted to invite me to dinner.
我讨厌在饭馆吃饭。	 wǒ tǎoyàn zài fànguǎn chīfàn。 	(吃饭: chīfàn) I hate to eat in the restaurant.
他总是一个人吃饭。	 tā zǒngshì yīgèrén chīfàn。 	(吃饭: chīfàn) He always eats alone.
好吧，出去吃饭。	 hǎo ba， chūqù chīfàn。 	(吃饭: chīfàn) All right, we'll go out to eat.
我今天晚上不吃饭。	 wǒ jīntiān wǎnshang bù chīfàn。 	(吃饭: chīfàn) I am not eating tonight.
怎么用筷子吃饭？	 zěnme yòng kuàizi chīfàn？ 	(吃饭: chīfàn) How do you use chopsticks to eat?
你吃不吃饭？	 nǐ chī bù chīfàn？ 	(吃饭: chīfàn) Will you eat?
吃饭了！	 chīfàn le！ 	(吃饭: chīfàn) Time to eat!
我吃饭了。	 wǒ chīfàn le。 	(吃饭: chīfàn) I've
我已经吃饭了。	 wǒ yǐjīng chīfàn le。 	(吃饭: chīfàn) I already ate.
你吃饭了吗？	 nǐ chīfàn le ma？ 	(吃饭: chīfàn) Did you eat?
现在可以吃饭吗？	 xiànzài kěyǐ chīfàn ma？ 	(吃饭: chīfàn) Can we eat now?
现在不可以吃饭吗？	 xiànzài bùkěyǐ chīfàn ma？ 	(吃饭: chīfàn) Can't I eat now?
在这里吃饭吧。	 zài zhèlǐ chīfàn ba。 	(吃饭: chīfàn) Let's eat here.
我在吃饭呢。	 wǒ zài chīfàn ne。 	(吃饭: chīfàn) I eat it.
超市里有各种水果。	 chāoshì lǐ yǒu gèzhǒng shuǐguǒ。 	(各种: gèzhǒng) Supermarkets have a variety of fruits.
谢谢您的合作。	 xièxie nín de hézuò。 	(合作: hézuò) Thank you for your cooperation.
我和同事一起开会。	 wǒ hé tóngshì yīqǐ kāihuì。 	(同事: tóngshì) My co-worker and I hold a meeting together.
我们是同学。	 wǒmen shì tóngxué。 	(同学: tóngxué) We're classmates.
她和我是同学。	 tā hé wǒ shì tóngxué。 	(同学: tóngxué) She and I are classmates.
她是我的同学。	 tā shì wǒ de tóngxué。 	(同学: tóngxué) She's my classmate.
同学们，你们好！	 tóngxué men， nǐmen hǎo！ 	(同学: tóngxué) Students, are you!
他被同学欺负。	 tā bèi tóngxué qīfu。 	(同学: tóngxué) He was made fun of by his classmates.
我都很同情他。	 wǒ dōu hěn tóngqíng tā。 	(同情: tóngqíng) I am very sorry for him.
我们同意。	 wǒmen tóngyì。 	(同意: tóngyì) We agree.
她和我同班。	 tā hé wǒ tóngbān。 	(同班: tóngbān) She and I are in the same class.
你和我同龄。	 nǐ hé wǒ tónglíng。 	(同龄: tónglíng) You and I are the same age.
我10分钟后回来。	 wǒ10 fēnzhōng hòu huílai。 	(后: hòu) I'll be back in ten minutes.
我在他后面。	 wǒ zài tā hòumian。 	(后面: hòumiàn) I'm behind him.
退到绳子后面。	 tuì dào shéngzi hòumian。 	(后面: hòumiàn) Stand back from the rope.
我蹲在沙发后面。	 wǒ dūn zài shāfā hòumian。 	(后面: hòumiàn) I crouched behind the sofa.
他站在我后面。	 tā zhàn zài wǒ hòumian。 	(后面: hòumiàn) He stands behind me.
谁躲在帘子后面？	 shéi duǒ zài liánzi hòumian？ 	(后面: hòumiàn) Who is hiding behind the curtain?
我们到车子后面推车。	 wǒmen dào chēzi hòumian tuīchē。 	(后面: hòumiàn) We got behind the car and pushed.
请向他表示感谢。	 qǐng xiàng tā biǎoshì gǎnxiè。 	(向: xiàng) Please express our gratitude to him.
我在听。	 wǒ zài tīng。 	(听: tīng) I'm listening.
他们没听。	 tāmen méi tīng。 	(听: tīng) They didn't listen.
你听一听。	 nǐ tīng yī tīng。 	(听: tīng) (You)
我听一下。	 wǒ tīng yīxià。 	(听: tīng) I'll have a listen.
我听你的。	 wǒ tīng nǐ de。 	(听: tīng) I heard you.
你们在听吗？	 nǐmen zài tīng ma？ 	(听: tīng) Are you listening?
别听她的。	 bié tīng tā de。 	(听: tīng) Don't listen to her.
别听她的。	 bié tīng tā de。 	(听: tīng) Don't listen to her.
爷爷正在听广播。	 yéye zhèngzài tīng guǎngbō。 	(听: tīng) Grandpa is listening to the radio.
听得不清楚	 tīng dé bùqīngchu 	(听: tīng) Not hear clearly
听父母的。	 tīng fùmǔ de。 	(听: tīng) Obey your parents.
要听老师的话。	 yào tīng lǎoshī dehuà。 	(听: tīng) Obey your teachers.
安静地听	 ānjìng dì tīng 	(听: tīng) Peacefully listen
你听到了吗？	 nǐ tīng dàoliǎo ma？ 	(听到: tīngdào) Did you hear it?
你听见了吗？	 nǐ tīngjiàn le ma？ 	(听见: tīngjiàn) Did you hear it?
这里比那里更吵。	 zhèlǐ bǐ nàli gèng chǎo。 	(吵: chǎo) It's even noisier here than there.
海绵吸水。	 hǎimián xīshuǐ。 	(吸: xī) A sponge absorbs water.
这部电影很吸引人。	 zhè bù diànyǐng hěn xīyǐn rén。 	(吸引: xīyǐn) The film is very attractive.
呀,下雪了！	 ya, xiàxuě le！ 	(呀: ya) Yeah, snow!
满月呈圆形。	 mǎnyuè chéng yuánxíng。 	(呈: chéng) The full moon has a circular form.
你可以告诉他。	 nǐ kěyǐ gàosu tā。 	(告诉: gàosù) You can tell him.
你不可以告诉他。	 nǐ bùkěyǐ gàosu tā。 	(告诉: gàosù) You can't tell him.
我们应该怎么告诉他？	 wǒmen yīnggāi zěnme gàosu tā？ 	(告诉: gàosù) How should we tell him?
我已经告诉他了。	 wǒ yǐjīng gàosu tā le。 	(告诉: gàosù) I've already told him.
我不会告诉你。	 wǒ bùhuì gàosu nǐ。 	(告诉: gàosù) I won't tell you.
你应该告诉我。	 nǐ yīnggāi gàosu wǒ。 	(告诉: gàosù) You should tell me.
看完以后告诉我。	 kàn wán yǐhòu gàosu wǒ。 	(告诉: gàosù) Tell me when you have finished watching.
她什么都告诉我。	 tā shénme dōu gàosu wǒ。 	(告诉: gàosù) She told me everything.
他在打电话呢。	 tā zài dǎdiànhuà ne。 	(呢: ne) He called it.
我在睡觉呢。	 wǒ zài shuìjiào ne。 	(呢: ne) I was sleeping.
儿子在睡觉呢。	 érzi zài shuìjiào ne。 	(呢: ne) Son sleeping.
我在吃饭呢。	 wǒ zài chīfàn ne。 	(呢: ne) I eat it.
我在看书呢。	 wǒ zài kànshū ne。 	(呢: ne) I'm reading it.
他在下飞机呢。	 tā zàixià fēijī ne。 	(呢: ne) He does the next plane.
他还没来呢。	 tā hái méi lái ne。 	(呢: ne) He has not come yet.
我在收拾行李呢。	 wǒ zài shōushi xíngli ne。 	(呢: ne) I pack yet.
现在呢？	 xiànzài ne？ 	(呢: ne) And now?
您下午做啥呢？	 nín xiàwǔ zuò shá ne？ 	(呢: ne) So what will you do in the afternoon?
你在忙什么呢？	 nǐ zài máng shénme ne？ 	(呢: ne) what are you busy with?
你究竟为什么哭呢？	 nǐ jiūjìng wèishénme kū ne？ 	(呢: ne) Why you crying?
这个好？那个呢？	 zhège hǎo？ nàge ne？ 	(呢: ne) This one is good? What about that one?
商店周一关门。	 shāngdiàn Zhōuyī guānmén。 	(周一: zhōuyī) The store is closed Mondays.
你周三要做什么？	 nǐ Zhōusān yào zuò shénme？ 	(周三: zhōusān) What are you doing on Wednesday?
我下周六有空。	 wǒ xiàzhōu liù yǒukòng。 	(周六: zhōuliù) I will be free next Saturday.
把下周日空出来。	 bǎ xiàzhōu rì kōng chūlái。 	(周日: zhōurì) Keep next Sunday free.
祝你周末愉快！	 zhù nǐ zhōumòyúkuài！ 	(周末: zhōumò) have a nice weekend!
我周末要在家睡觉。	 wǒ zhōumò yào zài jiā shuìjiào。 	(周末: zhōumò) During the weekend, I want to sleep at home.
猫有九命。	 māo yǒu jiǔ mìng。 	(命: mìng) A cat has nine lives.
猫有九命。	 māo yǒu jiǔ mìng。 	(命: mìng) A cat has nine lives.
北京和上海一样吗？	 Běijīng hé Shàng Hǎi yīyàng ma？ 	(和: hé) Are Beijing and Shanghai alike?
北京和上海差不多热。	 Běijīng hé Shàng Hǎi chàbuduō rè。 	(和: hé) Beijing and Shanghai are both just as hot.
我和他一起工作。	 wǒ hé tā yīqǐ gōngzuò。 	(和: hé) He and I work together.
我和他是朋友。	 wǒ hé tā shì péngyou。 	(和: hé) Me and him are friends.
我和同事一起开会。	 wǒ hé tóngshì yīqǐ kāihuì。 	(和: hé) My co-worker and I hold a meeting together.
爱和和平。	 ài hé hépíng。 	(和: hé) Love and Peace.
爸爸和妈妈都在家。	 bàba hé māma dōu zài jiā。 	(和: hé) Mom and Dad at home.
你和我。	 nǐ hé wǒ。 	(和: hé) You and I.
她和我同班。	 tā hé wǒ tóngbān。 	(和: hé) She and I are in the same class.
你和我同龄。	 nǐ hé wǒ tónglíng。 	(和: hé) You and I are the same age.
和我握手。	 hé wǒ wòshǒu。 	(和: hé) Shake my hand.
她和我是同学。	 tā hé wǒ shì tóngxué。 	(和: hé) She and I are classmates.
他们和我们一样酷。	 tāmen hé wǒmen yīyàng kù。 	(和: hé) They are as cool as we are.
我和朋友在酒吧。	 wǒ hé péngyou zài jiǔbā。 	(和: hé) I'm with a friend at a bar.
上海和纽约差不多。	 Shàng Hǎi hé Niǔyuē chàbuduō。 	(和: hé) Shanghai and New York are basically the same.
我喜欢可乐和茶。	 wǒ xǐhuan kělè hé chá。 	(和: hé) I like cola and tea.
啤酒和葡萄酒一样吗？	 píjiǔ hé pútaojiǔ yīyàng ma？ 	(和: hé) Are beer and wine the same?
商店卖水果和蔬菜。	 shāngdiàn mài shuǐguǒ hé shūcài。 	(和: hé) The store sells fruits and vegetables.
妙语和警句。	 miào yǔ hé jǐngjù。 	(和: hé) Quips and cranks.
爱和和平。	 ài hé hépíng。 	(和平: hépíng) Love and Peace.
很多咖啡厅都有wifi。	 hěn duō kāfēitīng dōu yǒuwifi。 	(咖啡厅: kāfēitīng) A lot of cafes have wifi.
咱们点两瓶吧。	 zánmen diǎn liǎng píng ba。 	(咱们: zánmen) Let's order two bottles.
那个帅哥姓张。	 nàge shuàigē xìng zhāng。 	(哥: gē) That handsome guy's last name is Zhang.
我在商场做售货员。	 wǒ zài shāngchǎng zuò shòuhuòyuán。 	(售货员: shòuhuòyuán) I do salesman at the mall.
高兴地唱	 gāoxìng dì chàng 	(唱: chàng) Happily sing
狗不会唱歌。	 gǒu bùhuì chànggē。 	(唱歌: chànggē) Dogs can't sing.
现在我们在KTV唱歌。	 xiànzài wǒmen zàiKTV chànggē。 	(唱歌: chànggē) Now we're at KTV singing songs.
狗会唱歌吗？	 gǒu huì chànggē ma？ 	(唱歌: chànggē) Dog can sing？
我在商场做售货员。	 wǒ zài shāngchǎng zuò shòuhuòyuán。 	(商场: shāngchǎng) I do salesman at the mall.
他去了商店。	 tā qù le shāngdiàn。 	(商店: shāngdiàn) He went to the store.
我想去商店。	 wǒ xiǎng qù shāngdiàn。 	(商店: shāngdiàn) I want to go to the store.
这个商店卖旧书。	 zhège shāngdiàn mài jiùshū。 	(商店: shāngdiàn) This store sells old books.
商店卖水果和蔬菜。	 shāngdiàn mài shuǐguǒ hé shūcài。 	(商店: shāngdiàn) The store sells fruits and vegetables.
让我去商店吧。	 ràng wǒ qù shāngdiàn ba。 	(商店: shāngdiàn) Let me go to the store.
商店周一关门。	 shāngdiàn Zhōuyī guānmén。 	(商店: shāngdiàn) The store is closed Mondays.
商店在学校很。	 shāngdiàn zài xuéxiào hěn。 	(商店: shāngdiàn) Stores in the school lot.
商店里有很多人。	 shāngdiàn lǐ yǒu hěn duō rén。 	(商店: shāngdiàn) The store had a lot of people.
你好啊!	 nǐhǎo ā! 	(啊: a) Hey, how's it going!
开啊！	 kāi ā！ 	(啊: a) Open up.
对啊！	 duì ā！ 	(啊: a) You're right!
小心啊！	 xiǎoxīn ā！ 	(啊: a) Be careful!
可以啊！	 kěyǐ ā！ 	(啊: a) It's fine!
多丢人啊！	 duō diūrén ā！ 	(啊: a) How shameful!
快点啊！	 kuàidiǎn ā！ 	(啊: a) Quickly!
不知道啊！	 bù zhīdào ā！ 	(啊: a) I don't know!
这里多么漂亮啊！	 zhèlǐ duōme piàoliang ā！ 	(啊: a) What a beautiful here, ah!
这里好漂亮啊！	 zhèlǐ hǎo piàoliang ā！ 	(啊: a) This place is so pretty!
我们都去啊！	 wǒmen dōu qù ā！ 	(啊: a) We're all going!
这个西瓜真甜啊！	 zhège xīguā zhēn tián ā！ 	(啊: a) The watermelon really sweet ah!
这个菜真好吃啊！	 zhège cài zhēn hǎochī ā！ 	(啊: a) This dish is really delicious!
学中文真难啊！	 xué Zhōngwén zhēn nán ā！ 	(啊: a) Learning Chinese is so hard!
不要忘了开会啊！	 bùyào wàng le kāihuì ā！ 	(啊: a) Don't forget to have the meeting!
天天加班，累啊！	 tiāntiān jiābān， lèi ā！ 	(啊: a) Working overtime every day is so tiring!
多么冷啊!。	 duōme lěng ā!。 	(啊: a) How cold it is!
你怎么样啊？	 nǐ zěnmeyàng ā？ 	(啊: a) So how have you been?
你傻啊？	 nǐ shǎ ā？ 	(啊: a) What are you, stupid?
那人谁啊？	 nà rén shéi ā？ 	(啊: a) Who is that person?
你去哪儿啊？	 nǐ qù nǎr ā？ 	(啊: a) Where are you going?
你是谁啊？	 nǐ shì shéi ā？ 	(啊: a) Who are you?
谁说的啊？	 shéi shuō de ā？ 	(啊: a) Who said so?
你走不走啊？	 nǐ zǒu bù zǒu ā？ 	(啊: a) Are you going or what?
你为什么来这里啊？	 nǐ wèishénme lái zhèlǐ ā？ 	(啊: a) What are you doing coming here?
你真不知道啊？	 nǐ zhēn bù zhīdào ā？ 	(啊: a) You really don't know?
这是啥？	 zhè shì shá？ 	(啥: shà) What's this?
您下午做啥呢？	 nín xiàwǔ zuò shá ne？ 	(啥: shà) So what will you do in the afternoon?
请每天喂一下狗。	 qǐng měitiān wèi yīxià gǒu。 	(喂: wèi) Please feed the dog every day.
饲养员正在喂动物。	 sìyǎngyuán zhèngzài wèi dòngwù。 	(喂: wèi) The keeper is feeding the animals.
我正在喂孩子。	 wǒ zhèngzài wèi háizi。 	(喂: wèi) I am feeding my baby.
我早上不喂狗。	 wǒ zǎoshang bù wèi gǒu。 	(喂: wèi) I don't feed my dog in the morning.
上善若水。	 shàng shàn ruò shuǐ。 	(善: shàn) The greatest good is akin to water.
我也喜欢。	 wǒ yě xǐhuan。 	(喜欢: xǐhuān) I like it too. / I also like it.
我什么女孩子都喜欢。	 wǒ shénme nǚháizi dōu xǐhuan。 	(喜欢: xǐhuān) I like all girls.
她一直很喜欢上海。	 tā yīzhí hěn xǐhuan Shàng Hǎi。 	(喜欢: xǐhuān) She has always liked Shanghai a lot.
我喜欢中国。	 wǒ xǐhuan Zhōngguó。 	(喜欢: xǐhuān) I like China.
他喜欢中国吗?。	 tā xǐhuan Zhōngguó ma?。 	(喜欢: xǐhuān) Does he like China?
我喜欢他。	 wǒ xǐhuan tā。 	(喜欢: xǐhuān) I like him.
我很喜欢他。	 wǒ hěn xǐhuan tā。 	(喜欢: xǐhuān) I really like him.
以前我不喜欢他。	 yǐqián wǒ bù xǐhuan tā。 	(喜欢: xǐhuān) Before, I didn't like him.
我以前不喜欢他。	 wǒ yǐqián bù xǐhuan tā。 	(喜欢: xǐhuān) Before, I didn't like him.
我很喜欢体育运动。	 wǒ hěn xǐhuan tǐyùyùndòng。 	(喜欢: xǐhuān) I love sports.
我喜欢你。	 wǒ xǐhuan nǐ。 	(喜欢: xǐhuān) I like you.
他不喜欢你。	 tā bù xǐhuan nǐ。 	(喜欢: xǐhuān) He does not like you.
很多人都喜欢你。	 hěn duō rén dōu xǐhuan nǐ。 	(喜欢: xǐhuān) A lot of people like you.
我最喜欢你了！	 wǒ zuì xǐhuan nǐ le！ 	(喜欢: xǐhuān) I like you the best!
安喜欢写诗。	 ān xǐhuan xiě shī。 	(喜欢: xǐhuān) Ann likes to write poems.
我喜欢写写东西。	 wǒ xǐhuan xiě xiě dōngxi。 	(喜欢: xǐhuān) I like to write a little bit.
我喜欢去学校。	 wǒ xǐhuan qù xuéxiào。 	(喜欢: xǐhuān) I like to go to school.
我喜欢可乐和茶。	 wǒ xǐhuan kělè hé chá。 	(喜欢: xǐhuān) I like cola and tea.
我喜欢吃。	 wǒ xǐhuan chī。 	(喜欢: xǐhuān) I like to eat.
我喜欢吃。	 wǒ xǐhuan chī。 	(喜欢: xǐhuān) I like to eat.
我什么都喜欢吃。	 wǒ shénme dōu xǐhuan chī。 	(喜欢: xǐhuān) I like eating everything.
我也喜欢吃水饺。	 wǒ yě xǐhuan chī shuǐjiǎo。 	(喜欢: xǐhuān) I like to eat boiled dumplings too.
你喜欢吗？	 nǐ xǐhuan ma？ 	(喜欢: xǐhuān) Do you like it?
你喜欢咖啡。	 nǐ xǐhuan kāfēi。 	(喜欢: xǐhuān) You like coffee.
你喜欢咖啡吗？	 nǐ xǐhuan kāfēi ma？ 	(喜欢: xǐhuān) Do you like coffee?
你喜欢哪种颜色？	 nǐ xǐhuan nǎ zhǒng yánsè？ 	(喜欢: xǐhuān) Which color do you like?
英国人都喜欢喝啤酒。	 Yīngguórén dōu xǐhuan hē píjiǔ。 	(喜欢: xǐhuān) British people all like drinking beer.
我喜欢学汉语。	 wǒ xǐhuan xué Hànyǔ。 	(喜欢: xǐhuān) I love to learn Chinese.
你喜欢学习汉语吗？	 nǐ xǐhuan xuéxí Hànyǔ ma？ 	(喜欢: xǐhuān) Do you like to learn Chinese?
你喜欢学校吗?。	 nǐ xǐhuan xuéxiào ma?。 	(喜欢: xǐhuān) Do you like school?
女儿很喜欢小狗。	 nǚ'ér hěn xǐhuan xiǎogǒu。 	(喜欢: xǐhuān) Daughter liked the dog.
我们喜欢差不多的菜。	 wǒmen xǐhuan chàbuduōde cài。 	(喜欢: xǐhuān) We like more or less the same food.
你不喜欢我了？	 nǐ bù xǐhuan wǒ le？ 	(喜欢: xǐhuān) You don't like me anymore?
我喜欢新鲜的果汁。	 wǒ xǐhuan xīnxiān de guǒzhī。 	(喜欢: xǐhuān) I like fresh fruit juice.
我很喜欢电影。	 wǒ hěn xǐhuan diànyǐng。 	(喜欢: xǐhuān) I like movies a lot.
我不喜欢电影。	 wǒ bù xǐhuan diànyǐng。 	(喜欢: xǐhuān) I don't like movies.
以前我不喜欢电影。	 yǐqián wǒ bù xǐhuan diànyǐng。 	(喜欢: xǐhuān) Before, I didn't like movies.
我以前不喜欢电影。	 wǒ yǐqián bù xǐhuan diànyǐng。 	(喜欢: xǐhuān) Before, I didn't like movies.
我喜欢看电影。	 wǒ xǐhuan kàn diànyǐng。 	(喜欢: xǐhuān) I like going to the movies.
以前她很喜欢笑。	 yǐqián tā hěn xǐhuan xiào。 	(喜欢: xǐhuān) Before, she really liked laughing.
她以前很喜欢笑。	 tā yǐqián hěn xǐhuan xiào。 	(喜欢: xǐhuān) Before, she really liked laughing.
不喜欢美国人的女孩	 bù xǐhuan Měiguórén de nǚhái 	(喜欢: xǐhuān) The girl that doesn't like Americans.
他喜欢茶。	 tā xǐhuan chá。 	(喜欢: xǐhuān) He likes tea.
他喜欢茶。	 tā xǐhuan chá。 	(喜欢: xǐhuān) He likes tea.
我喜欢茶。	 wǒ xǐhuan chá。 	(喜欢: xǐhuān) I like tea.
他很喜欢说话。	 tā hěn xǐhuan shuōhuà。 	(喜欢: xǐhuān) He really likes to talk
他不喜欢说话。	 tā bù xǐhuan shuōhuà。 	(喜欢: xǐhuān) He doesn't like to speak.
我喜欢读书。	 wǒ xǐhuan dúshū。 	(喜欢: xǐhuān) I like reading.
你喜欢读书吗？	 nǐ xǐhuan dúshū ma？ 	(喜欢: xǐhuān) Do you like reading it?
我们都很喜欢运动。	 wǒmen dōu hěn xǐhuan yùndòng。 	(喜欢: xǐhuān) We liked sports.
他喜欢这本书。	 tā xǐhuan zhè běn shū。 	(喜欢: xǐhuān) He likes this book.
我不喜欢这个派对。	 wǒ bù xǐhuan zhège pàiduì。 	(喜欢: xǐhuān) I don't like this party.
他要了水喝。	 tā yào le shuǐ hē。 	(喝: hē) He asked for a drink of water.
他要了水喝。	 tā yào le shuǐ hē。 	(喝: hē) He asked for a drink of water.
我们什么酒都喝。	 wǒmen shénme jiǔ dōu hē。 	(喝: hē) We can drink all alcohol.
我想喝一些牛奶。	 wǒ xiǎng hē yīxiē niúnǎi。 	(喝: hē) I want to drink some milk.
喝不喝可乐？	 hē bù hē kělè？ 	(喝: hē) Will you have some cola?
你喝不喝茶？	 nǐ hē bù hē chá？ 	(喝: hē) Do you drink tea or not?
你喝了什么？	 nǐ hē le shénme？ 	(喝: hē) What did you drink?
酒你喝了吗？	 jiǔ nǐ hē le ma？ 	(喝: hē) Did you drink alcohol?
他想喝些冷饮。	 tā xiǎng hē xiē lěngyǐn。 	(喝: hē) He wants something cold to drink.
想喝什么？	 xiǎng hē shénme？ 	(喝: hē) What do you want to drink?
想喝什么？	 xiǎng hē shénme？ 	(喝: hē) What do you want to drink?
您想喝什么？	 nín xiǎng hē shénme？ 	(喝: hē) What would you like to drink?
你想喝什么？	 nǐ xiǎng hē shénme？ 	(喝: hē) What would you like to drink?
我想喝冷饮。	 wǒ xiǎng hē lěngyǐn。 	(喝: hē) I want to drink something cold.
我要喝咖啡。	 wǒ yào hē kāfēi。 	(喝: hē) I want to drink coffee.
我想喝咖啡。	 wǒ xiǎng hē kāfēi。 	(喝: hē) I'd like to drink coffee.
你想喝咖啡吗？	 nǐ xiǎng hē kāfēi ma？ 	(喝: hē) Would you like to drink coffee?
我们去咖啡店喝咖啡吧。	 wǒmen qù kāfēidiàn hē kāfēi ba。 	(喝: hē) Let's go to the cafe and drink coffee.
爸爸爱喝啤酒。	 bàba ài hē píjiǔ。 	(喝: hē) Dad drink beer.
我在喝啤酒。	 wǒ zài hē píjiǔ。 	(喝: hē) I'm drinking beer.
我想喝啤酒。	 wǒ xiǎng hē píjiǔ。 	(喝: hē) I would like to drink beer.
英国人都喜欢喝啤酒。	 Yīngguórén dōu xǐhuan hē píjiǔ。 	(喝: hē) British people all like drinking beer.
我不想喝啤酒。	 wǒ bùxiǎng hē píjiǔ。 	(喝: hē) I wouldn't like to drink beer.
喝啤酒吧。	 hē píjiǔ ba。 	(喝: hē) Have some beer.
别喝太多酒。	 bié hē tài duō jiǔ。 	(喝: hē) Don't drink too much alcohol.
喝杯红茶吗？	 hē bēi hóngchá ma？ 	(喝: hē) Would you like a red-tea?
请喝杯茶吧。	 qǐng hē bēi chá ba。 	(喝: hē) Your cup of tea.
我想喝水。	 wǒ xiǎng hē shuǐ。 	(喝: hē) I want to drink water.
我应该喝点水。	 wǒ yīnggāi hē diǎnshuǐ。 	(喝: hē) I should drink a little water.
我昨天没喝葡萄酒。	 wǒ zuótiān méi hē pútaojiǔ。 	(喝: hē) I did not drink wine yesterday.
他从没喝过可乐。	 tā cóngméi hē guò kělè。 	(喝: hē) He has never been drunk cola.
我们喝茶，好不好？	 wǒmen hē chá， hǎobuhǎo？ 	(喝茶: hēchá) Let's have tea, OK?
我们喝茶，好吗？	 wǒmen hē chá， hǎo ma？ 	(喝茶: hēchá) Let's drink some tea, OK?
你喝茶。	 nǐ hē chá。 	(喝茶: hēchá) You drink tea.
B:我想喝茶。	 B: wǒ xiǎng hē chá。 	(喝茶: hēchá) I want to drink tea.
你喝不喝茶？	 nǐ hē bù hē chá？ 	(喝茶: hēchá) Do you drink tea or not?
A:谁想喝茶？	 A: shéi xiǎng hē chá？ 	(喝茶: hēchá) Who wants to drink tea?
你喝茶吗？	 nǐ hē chá ma？ 	(喝茶: hēchá) Do you drink tea?
把嘴张开！	 bǎ zuǐ zhāngkāi！ 	(嘴: zuǐ) Open your mouth!
你回信了吗？	 nǐ huíxìn le ma？ 	(回信: huíxìn) Have you answered that letter yet?
我回到了日本。	 wǒ huídào le Rìběn。 	(回到: huídào) I returned to Japan.
这个问题很容易回答。	 zhège wèntí hěn róngyì huídá。 	(回答: huídá) This question is easy to answer.
我能回答这个问题。	 wǒ néng huídá zhège wèntí。 	(回答: huídá) I can answer this question.
她不困。	 tā bù kùn。 	(困: kùn) She's not sleepy.
我困了。	 wǒ kùn le。 	(困: kùn) I'm sleepy.
你困吗？	 nǐ kùn ma？ 	(困: kùn) Are you sleepy?
你困吗？	 nǐ kùn ma？ 	(困: kùn) Are you sleepy?
他去图书馆。	 tā qù túshūguǎn。 	(图书馆: túshūguǎn) He goes to the library. / He's going to the library.
图书馆在四楼。	 túshūguǎn zài sì lóu。 	(图书馆: túshūguǎn) The library is on the 4th floor.
他在图书馆看书。	 tā zài túshūguǎn kànshū。 	(图书馆: túshūguǎn) He is reading in the library.
今晚的月亮真圆！	 jīnwǎn de yuèliang zhēn yuán！ 	(圆: yuán) Roundness of the moon tonight!
满月呈圆形。	 mǎnyuè chéng yuánxíng。 	(圆形: yuánxíng) The full moon has a circular form.
现在我们在KTV唱歌。	 xiànzài wǒmen zàiKTV chànggē。 	(在: zài) Now we're at KTV singing songs.
零在一前面。	 líng zài yī qiánmiàn。 	(在: zài) Zero comes before one.
男厕所在一层。	 náncè suǒzài yīcéng。 	(在: zài) The men's room on the first floor.
我在一个公司上班。	 wǒ zài yī gè gōngsī shàngbān。 	(在: zài) I work in a company.
我在上海。	 wǒ zài Shàng Hǎi。 	(在: zài) I'm in Shanghai.
我们都在上海。	 wǒmen dōu zài Shàng Hǎi。 	(在: zài) We are all in Shanghai.
我住在上海。	 wǒ zhù zài Shàng Hǎi。 	(在: zài) I live in Shanghai.
以前我住在上海。	 yǐqián wǒ zhù zài Shàng Hǎi。 	(在: zài) Before, I lived in Shanghai.
我以前住在上海。	 wǒ yǐqián zhù zài Shàng Hǎi。 	(在: zài) Before, I lived in Shanghai.
在上海买的衣服	 zài Shàng Hǎi mǎi de yīfu 	(在: zài) The clothes that were bought in Shanghai.
我在上海工作。	 wǒ zài Shàng Hǎi gōngzuò。 	(在: zài) I am working in Shanghai.
住在上海非常方便。	 zhù zài Shàng Hǎi fēicháng fāngbiàn。 	(在: zài) It is very convenient to live in Shanghai.
我现在在上班。	 wǒ xiànzài zài shàngbān。 	(在: zài) I am working now.
我在上网。	 wǒ zài shàngwǎng。 	(在: zài) I am surfing the internet.
他在下飞机呢。	 tā zàixià fēijī ne。 	(在: zài) He does the next plane.
还在下雨吗？	 hái zàixià yǔ ma？ 	(在: zài) Is it still raining?
我在中国学汉语。	 wǒ zài Zhōngguó xué Hànyǔ。 	(在: zài) I learn Chinese in China.
我哥哥在中国留学。	 wǒ gēge zài Zhōngguó liúxué。 	(在: zài) My brother studying in China.
他在买苹果。	 tā zài mǎi píngguǒ。 	(在: zài) He's buying apples.
他在买苹果。	 tā zài mǎi píngguǒ。 	(在: zài) He's buying apples.
我在他后面。	 wǒ zài tā hòumian。 	(在: zài) I'm behind him.
我坐在你右边。	 wǒ zuò zài nǐ yòubian。 	(在: zài) I sit on your right side.
你在公司吗？	 nǐ zài gōngsī ma？ 	(在: zài) Are you at the office?
我在公园。	 wǒ zài gōngyuán。 	(在: zài) I'm at the park.
手机在包里。	 shǒujī zài bāo lǐ。 	(在: zài) The cell-phone is in the bag.
我家在北京。	 wǒ jiā zài Běijīng。 	(在: zài) My home in Beijing.
我住在北京。	 wǒ zhù zài Běijīng。 	(在: zài) I live in Beijing.
我奶奶住在北京。	 wǒ nǎinai zhù zài Běijīng。 	(在: zài) My grandmother lived in Beijing.
他在医院。	 tā zài yīyuàn。 	(在: zài) He is in hospital.
我在医院工作。	 wǒ zài yīyuàn gōngzuò。 	(在: zài) I work in a hospital.
我在医院工作。	 wǒ zài yīyuàn gōngzuò。 	(在: zài) I work in a hospital.
他想在医院工作。	 tā xiǎng zài yīyuàn gōngzuò。 	(在: zài) He wants to work in a hospital.
我丈夫在医院工作。	 wǒ zhàngfu zài yīyuàn gōngzuò。 	(在: zài) My husband works in a hospital.
药局在医院附近。	 yàojú zài yīyuàn fùjìn。 	(在: zài) The pharmacy is near the hospital.
水果刀在厨房里。	 shuǐguǒdāo zài chúfáng lǐ。 	(在: zài) Fruit knife in the kitchen.
我在去。	 wǒ zài qù。 	(在: zài) I'm going.
狗在叫。	 gǒu zài jiào。 	(在: zài) The dog is barking.
狗在叫。	 gǒu zài jiào。 	(在: zài) The dog is barking.
有人在叫你。	 yǒurén zài jiào nǐ。 	(在: zài) Someone is calling you.
我在吃米饭。	 wǒ zài chī mǐfàn。 	(在: zài) I am eating rice.
我在吃饭呢。	 wǒ zài chīfàn ne。 	(在: zài) I eat it.
我在听。	 wǒ zài tīng。 	(在: zài) I'm listening.
你们在听吗？	 nǐmen zài tīng ma？ 	(在: zài) Are you listening?
学校在哪儿？	 xuéxiào zàinǎr？ 	(在: zài) Where is the school?
邮局在哪儿？	 yóujú zàinǎr？ 	(在: zài) Where's the post office?
我们在哪儿？	 wǒmen zàinǎr？ 	(在: zài) Where are we?
学校在哪儿？	 xuéxiào zàinǎr？ 	(在: zài) Where is the school?
你家在哪儿？	 nǐ jiā zàinǎr？ 	(在: zài) Where is your home?
你住在哪儿？	 nǐ zhù zàinǎr？ 	(在: zài) Where do you live?
请问，卫生间在哪儿？	 qǐngwèn， wèishēngjiān zàinǎr？ 	(在: zài) Excuse me, where is the bathroom?
你在哪儿?。	 nǐ zàinǎr?。 	(在: zài) Where are you?
奶茶在哪里？	 nǎichá zài nǎlǐ？ 	(在: zài) Where is the tea with milk?
苹果在哪里？	 píngguǒ zài nǎlǐ？ 	(在: zài) Where are the apples?
你爸爸在哪里？	 nǐ bàba zài nǎlǐ？ 	(在: zài) Where's your father?
您住在哪里？	 nín zhù zài nǎlǐ？ 	(在: zài) Where do you live?
你住在哪里？	 nǐ zhù zài nǎlǐ？ 	(在: zài) Where do you live?
我在商场做售货员。	 wǒ zài shāngchǎng zuò shòuhuòyuán。 	(在: zài) I do salesman at the mall.
我在喝啤酒。	 wǒ zài hē píjiǔ。 	(在: zài) I'm drinking beer.
图书馆在四楼。	 túshūguǎn zài sì lóu。 	(在: zài) The library is on the 4th floor.
他在图书馆看书。	 tā zài túshūguǎn kànshū。 	(在: zài) He is reading in the library.
别坐在地上。	 bié zuò zài dìshang。 	(在: zài) Don't sit on the floor.
他坐在地上。	 tā zuò zài dìshang。 	(在: zài) He was sitting on the floor.
不要扔在地上。	 bùyào rēng zài dìshang。 	(在: zài) Don't throw on the ground.
我在地铁里。	 wǒ zài dìtiě lǐ。 	(在: zài) I am in the metro.
他在学习汉语。	 tā zài xuéxí Hànyǔ。 	(在: zài) He was learning Chinese.
我在学校。	 wǒ zài xuéxiào。 	(在: zài) I'm at school.
商店在学校很。	 shāngdiàn zài xuéxiào hěn。 	(在: zài) Stores in the school lot.
我在学校读书。	 wǒ zài xuéxiào dúshū。 	(在: zài) I study at school.
我们都在学校里。	 wǒmen dōu zài xuéxiào lǐ。 	(在: zài) We are all in school.
你在家吗？	 nǐ zài jiā ma？ 	(在: zài) Are you at home?
我在家里。	 wǒ zài jiālǐ。 	(在: zài) I am in the house.
他在家里。	 tā zài jiālǐ。 	(在: zài) He is at home.
我们现在在山上！	 wǒmen xiànzài zài Shānshàng！ 	(在: zài) We are right now on top of the mountain!
谁躲在帘子后面？	 shéi duǒ zài liánzi hòumian？ 	(在: zài) Who is hiding behind the curtain?
宝宝在床上。	 bǎobǎo zài chuáng shàng。 	(在: zài) The baby is on the bed.
我们在开会。	 wǒmen zài kāihuì。 	(在: zài) We are in a meeting.
你是在开玩笑吧？	 nǐ shì zài kāiwánxiào ba？ 	(在: zài) Are you kidding?
你在忙什么呢？	 nǐ zài máng shénme ne？ 	(在: zài) what are you busy with?
他站在我后面。	 tā zhàn zài wǒ hòumian。 	(在: zài) He stands behind me.
爸爸在我旁边。	 bàba zài wǒ pángbiān。 	(在: zài) Dad next to me.
他在打电话呢。	 tā zài dǎdiànhuà ne。 	(在: zài) He called it.
我在收拾行李呢。	 wǒ zài shōushi xíngli ne。 	(在: zài) I pack yet.
书在桌子上。	 shū zài zhuōzi shàng。 	(在: zài) The book is on the table.
笔在桌子上。	 bǐ zài zhuōzi shàng。 	(在: zài) The pen is on the table.
钥匙在桌子上。	 yàoshi zài zhuōzi shàng。 	(在: zài) The keys are on the table.
水果在桌子上。	 shuǐguǒ zài zhuōzi shàng。 	(在: zài) Fruit on the table.
书在桌子上。	 shū zài zhuōzi shàng。 	(在: zài) Books on the table.
电脑在桌子上。	 diànnǎo zài zhuōzi shàng。 	(在: zài) Computer on the table.
小猫在桌子下面。	 xiǎomāo zài zhuōzi xiàmian。 	(在: zài) Kitten in the table below.
猫在桌子底下。	 māo zài zhuōzi dǐxia。 	(在: zài) The cat is under the table.
请坐在椅子上。	 qǐng zuò zài yǐzi shàng。 	(在: zài) Please sitting in a chair.
他在楼下。	 tā zài lóuxià。 	(在: zài) He is on the lower floor.
我蹲在沙发后面。	 wǒ dūn zài shāfā hòumian。 	(在: zài) I crouched behind the sofa.
我在洗手间。	 wǒ zài xǐshǒujiān。 	(在: zài) I'm in the bathroom.
在派对上见。	 zài pàiduì shàng jiàn。 	(在: zài) See you at the party.
她在浴室。	 tā zài yùshì。 	(在: zài) She's in the bath.
鱼在海里。	 yú zài hǎilǐ。 	(在: zài) The fish are in the sea.
我家在火车站的南边。	 wǒ jiā zài huǒchēzhàn de nánbian。 	(在: zài) My home in the south train station.
我在看书呢。	 wǒ zài kànshū ne。 	(在: zài) I'm reading it.
她在看书。	 tā zài kànshū。 	(在: zài) She is reading.
妈妈在看电视。	 māma zài kàn diànshì。 	(在: zài) Mother watching TV.
婴儿在睡觉。	 yīng'ér zài shuìjiào。 	(在: zài) The baby is sleeping.
他在睡觉吗?。	 tā zài shuìjiào ma?。 	(在: zài) Is he sleeping?
我在睡觉呢。	 wǒ zài shuìjiào ne。 	(在: zài) I was sleeping.
儿子在睡觉呢。	 érzi zài shuìjiào ne。 	(在: zài) Son sleeping.
我在等他。	 wǒ zài děng tā。 	(在: zài) I'm waiting for him.
购物可以在网上付款。	 gòuwù kěyǐ zài wǎngshàng fùkuǎn。 	(在: zài) Shopping can pay online.
我们经常在网上聊天。	 wǒmen jīngcháng zài wǎngshàng liáotiān。 	(在: zài) We often chat online.
他们在英国。	 tāmen zài Yīngguó。 	(在: zài) They're in England.
我们公司在西安。	 wǒmen gōngsī zài Xī'ān。 	(在: zài) Our company is in Xi'an.
你在说什么？	 nǐ zài shuō shénme？ 	(在: zài) what are you saying?
他们在说话。	 tāmen zài shuōhuà。 	(在: zài) They talk.
是谁在读？	 shì shéi zài dú？ 	(在: zài) Who is reading?
他在超市。	 tā zài chāoshì。 	(在: zài) He's at the supermarket.
不要站在路中间。	 bùyào zhàn zài lù zhōngjiān。 	(在: zài) Don't stand in the middle of the road.
我在这个公司工作。	 wǒ zài zhège gōngsī gōngzuò。 	(在: zài) I work at this company.
在这里不能游泳。	 zài zhèlǐ bùnéng yóuyǒng。 	(在: zài) You can't swim here.
在这里吃饭吧。	 zài zhèlǐ chīfàn ba。 	(在: zài) Let's eat here.
比赛还在进行。	 bǐsài hái zài jìnxíng。 	(在: zài) Game still in progress.
她在邮局。	 tā zài yóujú。 	(在: zài) She's at the post office.
我和朋友在酒吧。	 wǒ hé péngyou zài jiǔbā。 	(在: zài) I'm with a friend at a bar.
我在酒吧喝酒。	 wǒ zài jiǔbā hējiǔ。 	(在: zài) I am drinking at the bar.
我在门外等你。	 wǒ zài ménwài děng nǐ。 	(在: zài) I'll wait for you at the door.
她住在附近。	 tā zhù zài fùjìn。 	(在: zài) She lives nearby.
我在饭馆做服务员。	 wǒ zài fànguǎn zuò fúwùyuán。 	(在: zài) I was a waitress at the restaurant.
我讨厌在饭馆吃饭。	 wǒ tǎoyàn zài fànguǎn chīfàn。 	(在: zài) I hate to eat in the restaurant.
我妈妈不在家。	 wǒ māma bùzài jiā。 	(在家: zàijiā) My mother was not at home.
Ken中午以前会在家。	 Ken zhōngwǔ yǐqián huì zài jiā。 	(在家: zàijiā) Ken will be at home until noon.
爸爸和妈妈都在家。	 bàba hé māma dōu zài jiā。 	(在家: zàijiā) Mom and Dad at home.
我从不一个人在家。	 wǒ cóngbù yīgèrén zài jiā。 	(在家: zàijiā) I have never been home alone.
我周末要在家睡觉。	 wǒ zhōumò yào zài jiā shuìjiào。 	(在家: zàijiā) During the weekend, I want to sleep at home.
安静地听	 ānjìng dì tīng 	(地: de) Peacefully listen
高兴地唱	 gāoxìng dì chàng 	(地: de) Happily sing
北京那么快地改变。	 Běijīng nàme kuài dì gǎibiàn。 	(地: de) Beijing is changing so rapidly.
我们热情地欢迎客人。	 wǒmen rèqíng dì huānyíng kèrén。 	(地: de) We warmly welcome guests.
妹妹开心地笑了。	 mèimei kāixīn dì xiào le。 	(地: de) Sister laughed.
开心地笑	 kāixīn dì xiào 	(地: de) Happily laugh
慢慢地说	 mànmàn dì shuō 	(地: de) Slowly talk
天慢慢地黑了。	 tiān mànmàn dì hēi le。 	(地: de) Days slowly dark.
别坐在地上。	 bié zuò zài dìshang。 	(地上: dìshàng) Don't sit on the floor.
他坐在地上。	 tā zuò zài dìshang。 	(地上: dìshàng) He was sitting on the floor.
不要扔在地上。	 bùyào rēng zài dìshang。 	(地上: dìshàng) Don't throw on the ground.
地上有一毛钱。	 dìshang yǒu yī máo qián。 	(地上: dìshàng) On the ground have a dime.
那个地方不太远。	 nàge dìfang bù tài yuǎn。 	(地方: dìfāng) That place is not very far away.
这个地方从不下雪。	 zhège dìfang cóngbù xiàxuě。 	(地方: dìfāng) It never snows at this place.
这个地方从来不下雪。	 zhège dìfang cóngláibù xiàxuě。 	(地方: dìfāng) It never snows at this place.
这个地方叫外滩。	 zhège dìfang jiào Wàitān。 	(地方: dìfāng) This place is called the Bund.
两个地方差不多远。	 liǎng gè dìfang chàbuduō yuǎn。 	(地方: dìfāng) The two places are both just as far away.
这个地方还好。	 zhège dìfang háihǎo。 	(地方: dìfāng) This place is OK.
现在什么地方都热。	 xiànzài shénmedìfang dōu rè。 	(地方: dìfāng) Right now it's hot everywhere.
上个星期去的地方	 shànggèxīngqī qù de dìfang 	(地方: dìfāng) The place we went to last week.
地球比太阳小。	 dìqiú bǐ tàiyang xiǎo。 	(地球: dìqiú) The earth is small in comparison with the sun.
我们一起坐地铁上班。	 wǒmen yīqǐ zuò dìtiě shàngbān。 	(地铁: dìtiě) We take the metro together to work.
地铁还是出租车？	 dìtiě háishi chūzūchē？ 	(地铁: dìtiě) Subway or taxi?
我在地铁里。	 wǒ zài dìtiě lǐ。 	(地铁: dìtiě) I am in the metro.
你真坏。	 nǐ zhēn huài。 	(坏: huài) You're so bad.
他很坏。	 tā hěn huài。 	(坏: huài) He's bad.
电视坏了。	 diànshì huàile。 	(坏: huài) The television doesn't work.
电脑坏了。	 diànnǎo huàile。 	(坏: huài) The computer is broken.
水果快坏了。	 shuǐguǒ kuài huàile。 	(坏: huài) The fruit is almost ruined.
请坐！	 qǐng zuò！ 	(坐: zuò) Please sit down!
请坐！	 qǐng zuò！ 	(坐: zuò) Please sit here.
没有椅子坐。	 méiyǒu yǐzi zuò。 	(坐: zuò) There's no chair to sit upon.
请坐一下。	 qǐng zuò yīxià。 	(坐: zuò) Please sit down.
我们坐出租车去火车站。	 wǒmen zuò chūzūchē qù huǒchēzhàn。 	(坐: zuò) We take a taxi to the train station.
大家请随便坐吧。	 dàjiā qǐng suíbiàn zuò ba。 	(坐: zuò) Everyone please just sit down.
我坐在你右边。	 wǒ zuò zài nǐ yòubian。 	(坐: zuò) I sit on your right side.
别坐在地上。	 bié zuò zài dìshang。 	(坐: zuò) Don't sit on the floor.
他坐在地上。	 tā zuò zài dìshang。 	(坐: zuò) He was sitting on the floor.
请坐在椅子上。	 qǐng zuò zài yǐzi shàng。 	(坐: zuò) Please sitting in a chair.
我们一起坐地铁上班。	 wǒmen yīqǐ zuò dìtiě shàngbān。 	(坐: zuò) We take the metro together to work.
坐我旁边。	 zuò wǒ pángbiān。 	(坐: zuò) Sit beside me.
我们坐电梯上去吧。	 wǒmen zuò diàntī shàngqù ba。 	(坐: zuò) We took the elevator to go.
我们坐电梯上楼。	 wǒmen zuò diàntī shànglóu。 	(坐: zuò) We took the elevator upstairs.
我坐飞机去北京。	 wǒ zuòfēijī qù Běijīng。 	(坐: zuò) I fly to Beijing.
我坐飞机去中国。	 wǒ zuòfēijī qù Zhōngguó。 	(坐: zuò) I fly to China.
请坐下。	 qǐng zuòxia。 	(坐下: zuòxià) Please sit down.
她叫他坐下。	 tā jiào tā zuòxia。 	(坐下: zuòxià) She asked him to sit down.
你可以坐船去上海。	 nǐ kěyǐ zuò chuán qù Shàng Hǎi。 	(坐船: zuòchuán) You can boat to Shanghai.
一块七	 yīkuài qī 	(块: kuài) One kuai seven
两百一十二块三	 liǎng bǎi yī shí'èr kuài sān 	(块: kuài) Two hundred and twelve kuai three
九块五	 jiǔ kuài wǔ 	(块: kuài) Nine kuai five
五十块五	 wǔshí kuài wǔ 	(块: kuài) Fifty kuai five
一千三百五十八块五	 yī qiān sān bǎi wǔshí bā kuài wǔ 	(块: kuài) One thousand three hundred and fifty-eight kuai five
二十三块八	 èrshí sān kuài bā 	(块: kuài) Twenty-three kuai eight
七十二块四	 qīshí èr kuài sì 	(块: kuài) Seventy-two kuai four
一百七十二块四	 yī bǎi qīshí èr kuài sì 	(块: kuài) One hundred and seventy-two kuai four
六块巧克力	 liù kuài qiǎokèlì 	(块: kuài) six pieces of chocolate
一块巧克力	 yīkuài qiǎokèlì 	(块: kuài) a piece of chocolate
那块巧克力	 nà kuài qiǎokèlì 	(块: kuài) that piece of chocolate
那有两块蛋糕。	 nà yǒu liǎng kuài dàngāo。 	(块: kuài) There were two pieces of cake.
来吃块西瓜吧。	 lái chī kuài xīguā ba。 	(块: kuài) Eat watermelon block it.
这本书三十块钱。	 zhè běn shū sānshí kuài qián。 	(块: kuài) This book is thirty dollars.
一个苹果三块钱。	 yī gè píngguǒ sān kuài qián。 	(块: kuài) Three dollars an apple.
两块钱	 liǎng kuài qián 	(块: kuài) 2 kuai / 2 RMB
我想吃块儿糖。	 wǒ xiǎng chī kuài r táng。 	(块儿: kuàier) I eat pieces of sugar.
请吃块儿西瓜。	 qǐng chī kuài r xīguā。 	(块儿: kuàier) Please eat watermelon pieces.
街上有许多垃圾桶。	 jiēshang yǒu xǔduō lājītǒng。 	(垃圾桶: lèsètǒng) There are a lot of trash on the street.
上海比别的城市方便。	 Shàng Hǎi bǐ biéde chéngshì fāngbiàn。 	(城市: chéngshì) Shanghai is more convenient than other cities.
它太大声。	 tā tài dàshēng。 	(声: shēng) It's too loud.
请说大声一点儿。	 qǐng shuō dàshēng yīdiǎnr。 	(声: shēng) Please speak more loudly.
它有多复杂？	 tā yǒu duō fùzá？ 	(复杂: fùzá) How complex is it?
今年夏天太热了。	 jīnnián xiàtiān tài rè le。 	(夏天: xiàtiān) This summer too hot.
我们绝少外出。	 wǒmen jué shǎo wàichū。 	(外出: wàichū) We go out very seldom.
这个地方叫外滩。	 zhège dìfang jiào Wàitān。 	(外滩: wàitān) This place is called the Bund.
外面下雨了。	 wàimiàn xiàyǔ le。 	(外面: wàimiàn) Raining outside.
外面多冷？	 wàimiàn duō lěng？ 	(外面: wàimiàn) How cold is it outside?
外面多热？	 wàimiàn duō rè？ 	(外面: wàimiàn) How hot is it outside?
外面多舒服！	 wàimiàn duō shūfu！ 	(外面: wàimiàn) It's so nice outside!
他多重？	 tā duōchóng？ 	(多重: duōchóng) How heavy is he?
这个星期我上夜班。	 zhège xīngqī wǒ shàng yèbān。 	(夜班: yèbān) I'm doing night duty this week.
钱够吗？	 qián gòu ma？ 	(够: gòu) Was there enough money?
今天~冷的。够	 jīntiān~ lěng de。 gòu 	(够: gòu) Today ~ cold. Enough
山上有一大片森林。	 Shānshàng yǒu yī dàpiàn sēnlín。 	(大片: dàpiàn) There is a large mountain forest.
大约十点钟吗？	 dàyuē shí diǎnzhōng ma？ 	(大约: dàyuē) Is it about ten o'clock?
大街上非常热闹。	 dà jiēshang fēicháng rènao。 	(大街: dàjiē) The street is very busy.
大象太大了。	 dàxiàng tài dà le。 	(大象: dàxiàng) The elephant is very big.
大象很大。	 dàxiàng hěn dà。 	(大象: dàxiàng) The elephant is big.
天气冷了。	 tiānqì lěng le。 	(天气: tiānqì) The weather is getting cold.
天气变阴了。	 tiānqì biàn yīn le。 	(天气: tiānqì) The weather turned bad.
秋天的天气很凉快。	 qiūtiān de tiānqì hěn liángkuai。 	(天气: tiānqì) Autumn weather is very cool.
今天天气很好。	 jīntiān tiānqì hěn hǎo。 	(天气: tiānqì) The weather today is good.
天气怎么样？	 tiānqì zěnmeyàng？ 	(天气: tiānqì) What's the weather like?
天气怎样？	 tiānqì zěnyàng？ 	(天气: tiānqì) How is the weather?
天气挺凉爽。	 tiānqì tǐng liángshuǎng。 	(天气: tiānqì) The weather is quite pleasantly cool.
今天天气比较冷。	 jīntiān tiānqì bǐjiào lěng。 	(天气: tiānqì) Today the weather is cold.
天气热点儿没关系。	 tiānqì rè diǎnr méiguānxi。 	(天气: tiānqì) I don't mind if the weather is hot.
天气真好！	 tiānqì zhēn hǎo！ 	(天气: tiānqì) The weather is really great!
这个天气真讨厌。	 zhège tiānqì zhēn tǎoyàn。 	(天气: tiānqì) I hate this weather.
今天的天气非常好。	 jīntiān de tiānqì fēicháng hǎo。 	(天气: tiānqì) Today's weather is very good.
太极拳怎么打？	 tàijíquán zěnme dǎ？ 	(太极拳: tàijíquán) How do you do tai chi?
地球比太阳小。	 dìqiú bǐ tàiyang xiǎo。 	(太阳: tàiyáng) The earth is small in comparison with the sun.
我对他很失望。	 wǒ duì tā hěn shīwàng。 	(失望: shīwàng) I told him very disappointed.
不喜欢美国人的女孩	 bù xǐhuan Měiguórén de nǚhái 	(女孩: nǚhái) The girl that doesn't like Americans.
漂亮的女孩儿	 piàoliang de nǚháir 	(女孩儿: nǚháiér) Beautiful girl.
怎么跟女孩子说话？	 zěnme gēn nǚháizi shuōhuà？ 	(女孩子: nǚháizi) How do you talk to girls?
这个女孩子还算漂亮。	 zhège nǚháizi hái suàn piàoliang。 	(女孩子: nǚháizi) This girl is fairly beautiful.
我什么女孩子都喜欢。	 wǒ shénme nǚháizi dōu xǐhuan。 	(女孩子: nǚháizi) I like all girls.
我奶奶不用手机。	 wǒ nǎinai bùyòng shǒujī。 	(奶奶: nǎinai) My grandma doesn't use a cellphone.
我奶奶住在北京。	 wǒ nǎinai zhù zài Běijīng。 	(奶奶: nǎinai) My grandmother lived in Beijing.
奶茶在哪里？	 nǎichá zài nǎlǐ？ 	(奶茶: nǎichá) Where is the tea with milk?
这个奶茶有点甜。	 zhège nǎichá yǒudiǎn tián。 	(奶茶: nǎichá) This milk tea is a little sweet.
我们之间好像有误会。	 wǒmen zhījiān hǎoxiàng yǒu wùhuì。 	(好像: hǎoxiàng) There is a misunderstanding between us seems.
这首歌很好听。	 zhè shǒugē hěn hǎotīng。 	(好听: hǎotīng) This song is great.
这种啤酒多好喝！	 zhèzhǒng píjiǔ duō hǎohē！ 	(好喝: hǎohē) This kind of beer tastes great!
这种啤酒最好喝。	 zhèzhǒng píjiǔ zuìhǎo hē。 	(好喝: hǎohē) This beer is the best tasting.
这种酒也很好喝。	 zhèzhǒng jiǔ yě hěn hǎohē。 	(好喝: hǎohē) This kind of alcohol is also very good.
这里的咖啡不好喝。	 zhèlǐ de kāfēi bùhǎo hē。 	(好喝: hǎohē) The coffee here is not good.
啤酒比白酒更好喝。	 píjiǔ bǐ báijiǔ gèng hǎohē。 	(好喝: hǎohē) Beer is better to drink than white wine.
好喝的啤酒	 hǎohē de píjiǔ 	(好喝: hǎohē) Great-tasting beer.
这本书很好懂。	 zhè běn shū hěn hǎo dǒng。 	(好懂: hǎodǒng) This book is easy to understand.
这个游戏多好玩！	 zhège yóuxì duō hǎowán！ 	(好玩: hǎowán) This game is so much fun!
我觉得上海很好玩。	 wǒ juéde Shàng Hǎi hěn hǎowán。 	(好玩: hǎowán) I think Shanghai is a lot of fun.
十减二等如八。	 shí jiǎn èrděng rú bā。 	(如: rú) Subtract two from ten and you have eight.
妙语和警句。	 miào yǔ hé jǐngjù。 	(妙语: miàoyǔ) Quips and cranks.
我有两个妹妹。	 wǒ yǒu liǎng gè mèimei。 	(妹妹: mèimei) I have two younger sisters.
妹妹开心地笑了。	 mèimei kāixīn dì xiào le。 	(妹妹: mèimei) Sister laughed.
我妻子上班去了。	 wǒ qīzi shàngbān qù le。 	(妻子: qīzi) My wife went to work.
汤姆在家里。	 Tāngmǔ zài jiālǐ。 	(姆在: mǔzài) Tom is in the house.
汤姆比我大。	 Tāngmǔ bǐ wǒ dà。 	(姆比: mǔbǐ) Tom is bigger than me.
我有两个姐姐。	 wǒ yǒu liǎng gè jiějie。 	(姐姐: jiějiě) I have two sisters.
你姐姐很难看。	 nǐ jiějie hěn nánkàn。 	(姐姐: jiějiě) Your older sister is ugly.
你的姐姐最聪明。	 nǐ de jiějie zuì cōngming。 	(姐姐: jiějiě) Your sister is the cleverest.
我姓于。	 wǒ xìng yú。 	(姓: xìng) My last name is Yu.
你姓什么?	 nǐ xìng shénme? 	(姓: xìng) What is your last name?
我姓张。	 wǒ xìng zhāng。 	(姓: xìng) I Zhang.
那个帅哥姓张。	 nàge shuàigē xìng zhāng。 	(姓: xìng) That handsome guy's last name is Zhang.
他姓李。	 tā xìng lǐ。 	(姓: xìng) His last name is Li.
我们都姓李。	 wǒmen dōu xìng lǐ。 	(姓: xìng) All of our last names are Li.
我姓杨。	 wǒ xìng yáng。 	(姓: xìng) My last name is Yang.
你好，我姓毛。	 nǐhǎo， wǒ xìng máo。 	(姓: xìng) Hello. My last name is Mao.
我姓王。	 wǒ xìng wáng。 	(姓: xìng) My last name is Wang.
我女朋友姓钱。	 wǒ nǚpéngyou xìng qián。 	(姓: xìng) My girlfriend's last name is Qian.
婴儿在睡觉。	 yīng'ér zài shuìjiào。 	(婴儿: yīng'ér) The baby is sleeping.
我学习。	 wǒ xuéxí。 	(学习: xuéxí) I study.
我讨厌学习。	 wǒ tǎoyàn xuéxí。 	(学习: xuéxí) I hate studying.
以前我很爱学习。	 yǐqián wǒ hěn ài xuéxí。 	(学习: xuéxí) Before, I really loved studying.
我以前很爱学习。	 wǒ yǐqián hěn ài xuéxí。 	(学习: xuéxí) Before, I really loved studying.
我没有学习中文。	 wǒ méiyǒu xuéxí Zhōngwén。 	(学习: xuéxí) I didn't study Chinese.
我没学习中文。	 wǒ méi xuéxí Zhōngwén。 	(学习: xuéxí) I didn't study Chinese.
你不要学习了。	 nǐ bùyào xuéxí le。 	(学习: xuéxí) Don't study.
学生们学习很努力。	 xuésheng men xuéxí hěn nǔlì。 	(学习: xuéxí) The students study very hard.
我学习汉语。	 wǒ xuéxí Hànyǔ。 	(学习: xuéxí) I'm learning Chinese.
他学习汉语。	 tā xuéxí Hànyǔ。 	(学习: xuéxí) He studies Chinese.
他也学习汉语。	 tā yě xuéxí Hànyǔ。 	(学习: xuéxí) He studies Chinese as well.
他在学习汉语。	 tā zài xuéxí Hànyǔ。 	(学习: xuéxí) He was learning Chinese.
你喜欢学习汉语吗？	 nǐ xǐhuan xuéxí Hànyǔ ma？ 	(学习: xuéxí) Do you like to learn Chinese?
今天我们学习第一课。	 jīntiān wǒmen xuéxí dìyī kè。 	(学习: xuéxí) Today we learned the first lesson.
每天学习英文。	 měitiān xuéxí Yīngwén。 	(学习: xuéxí) Study English every day.
她上午学习英语。	 tā shàngwǔ xuéxí Yīngyǔ。 	(学习: xuéxí) She studied English in the morning.
我们学习音乐。	 wǒmen xuéxí yīnyuè。 	(学习: xuéxí) We study music.
我去学校。	 wǒ qù xuéxiào。 	(学校: xuéxiào) I go to school.
我去学校。	 wǒ qù xuéxiào。 	(学校: xuéxiào) I go to school.
我在学校。	 wǒ zài xuéxiào。 	(学校: xuéxiào) I'm at school.
我去学校。	 wǒ qù xuéxiào。 	(学校: xuéxiào) I go to school. / I'm going to school.
我喜欢去学校。	 wǒ xǐhuan qù xuéxiào。 	(学校: xuéxiào) I like to go to school.
我想去学校。	 wǒ xiǎng qù xuéxiào。 	(学校: xuéxiào) I want to go to school.
他昨天没去学校。	 tā zuótiān méi qù xuéxiào。 	(学校: xuéxiào) He did not go to school yesterday.
我们学校不大。	 wǒmen xuéxiào bùdà。 	(学校: xuéxiào) Our school is not big.
你喜欢学校吗?。	 nǐ xǐhuan xuéxiào ma?。 	(学校: xuéxiào) Do you like school?
学校在哪儿？	 xuéxiào zàinǎr？ 	(学校: xuéxiào) Where is the school?
学校在哪儿？	 xuéxiào zàinǎr？ 	(学校: xuéxiào) Where is the school?
这个学校太大了。	 zhège xuéxiào tài dà le。 	(学校: xuéxiào) The school is too big.
商店在学校很。	 shāngdiàn zài xuéxiào hěn。 	(学校: xuéxiào) Stores in the school lot.
我们学校很大。	 wǒmen xuéxiào hěn dà。 	(学校: xuéxiào) Our school great.
我们学校很大。	 wǒmen xuéxiào hěn dà。 	(学校: xuéxiào) Our school is big.
我家离学校很近。	 wǒ jiā lí xuéxiào hěn jìn。 	(学校: xuéxiào) My home is near the school.
你们学校有多少学生？	 nǐmen xuéxiào yǒu duōshao xuésheng？ 	(学校: xuéxiào) How many students in your school?
那个学校的老师	 nàge xuéxiào de lǎoshī 	(学校: xuéxiào) The teacher of that school.
我在学校读书。	 wǒ zài xuéxiào dúshū。 	(学校: xuéxiào) I study at school.
那个学校还可以。	 nàge xuéxiào hái kěyǐ。 	(学校: xuéxiào) That school is so-so.
我们都在学校里。	 wǒmen dōu zài xuéxiào lǐ。 	(学校: xuéxiào) We are all in school.
我的学校	 wǒ de xuéxiào 	(学校: xuéxiào) My school
你是学生。	 nǐ shì xuésheng。 	(学生: xuéshēng) You are a student.
您是学生。	 nín shì xuésheng。 	(学生: xuéshēng) You are a student.
我是学生。	 wǒ shì xuésheng。 	(学生: xuéshēng) I am a student.
你是学生。	 nǐ shì xuésheng。 	(学生: xuéshēng) You are a student.
我不是学生。	 wǒ bùshì xuésheng。 	(学生: xuéshēng) I am not a student.
你不是学生。	 nǐ bùshì xuésheng。 	(学生: xuéshēng) You are not a student.
我不是学生。	 wǒ bùshì xuésheng。 	(学生: xuéshēng) I'm not a student.
我是一个学生。	 wǒ shì yī gè xuésheng。 	(学生: xuéshēng) I am a student.
他不是学生。	 tā bùshì xuésheng。 	(学生: xuéshēng) He is not a student.
我们都是学生。	 wǒmen dōu shì xuésheng。 	(学生: xuéshēng) We are all students.
我不是好学生。	 wǒ bùshì hǎo xuésheng。 	(学生: xuéshēng) I am not a good student.
你们学校有多少学生？	 nǐmen xuéxiào yǒu duōshao xuésheng？ 	(学生: xuéshēng) How many students in your school?
学生们学习很努力。	 xuésheng men xuéxí hěn nǔlì。 	(学生: xuéshēng) The students study very hard.
你是学生吗？	 nǐ shì xuésheng ma？ 	(学生: xuéshēng) Are you a student?
您是学生吗？	 nín shì xuésheng ma？ 	(学生: xuéshēng) Are you a student?
你是学生吗？	 nǐ shì xuésheng ma？ 	(学生: xuéshēng) Are you a student?
你是个学生吧？	 nǐ shì gè xuésheng ba？ 	(学生: xuéshēng) You're a student, right?
先生的学问博大精深。	 xiānsheng de xuéwèn bódàjīngshēn。 	(学问: xuéwèn) The teacher had both extensive knowledge and profound scholarship.
我们没有孩子。	 wǒmen méiyǒu háizi。 	(孩子: háizi) We don't have children.
我正在喂孩子。	 wǒ zhèngzài wèi háizi。 	(孩子: háizi) I am feeding my baby.
我有三个孩子。	 wǒ yǒu sān gè háizi。 	(孩子: háizi) I have three children.
孩子又哭了起来。	 háizi yòu kū le qilai。 	(孩子: háizi) Children cried again.
这个孩子怎么不害羞？	 zhège háizi zěnme bù hàixiū？ 	(孩子: háizi) Why is this child not shy?
这个孩子怎么这么害羞？	 zhège háizi zěnme zhème hàixiū？ 	(孩子: háizi) How can this little girl be so shy?
教育孩子要有耐心。	 jiàoyù háizi yàoyǒu nàixīn。 	(孩子: háizi) Teaching children to be patient.
它多贵?。	 tā duō guì?。 	(它: tā) How much is it?
它太大声。	 tā tài dàshēng。 	(它: tā) It's too loud.
它有多复杂？	 tā yǒu duō fùzá？ 	(它: tā) How complex is it?
安喜欢写诗。	 ān xǐhuan xiě shī。 	(安: ān) Ann likes to write poems.
安有很多朋友。	 ān yǒu hěn duō péngyou。 	(安: ān) Ann has many friends.
请注意安全。	 qǐng zhùyì ānquán。 	(安全: ānquán) Please pay attention to safety.
晚上开车要注意安全。	 wǎnshang kāichē yào zhùyì ānquán。 	(安全: ānquán) Pay attention to safety when driving at night.
这里还算安静。	 zhèlǐ hái suàn ānjìng。 	(安静: ānjìng) This place is fairly quiet.
安静地听	 ānjìng dì tīng 	(安静: ānjìng) Peacefully listen
我今天要做完。	 wǒ jīntiān yào zuòwán。 	(完: wán) I'm going to finish doing it today.
我说完了。	 wǒ shuō wánle。 	(完: wán) I am finished talking.
面包已经卖完了。	 miànbāo yǐjīng mài wánle。 	(完: wán) Bread has been sold out.
我们已经做完了。	 wǒmen yǐjīng zuò wánle。 	(完: wán) We have already finished it.
工作差不多做完了。	 gōngzuò chàbuduō zuò wánle。 	(完: wán) Work is almost over.
我已经做完了。	 wǒ yǐjīng zuò wánle。 	(完: wán) I already finished it.
你吃完了吗？	 nǐ chī wánle ma？ 	(完: wán) Are you done eating?
看完以后告诉我。	 kàn wán yǐhòu gàosu wǒ。 	(完: wán) Tell me when you have finished watching.
我刚吃完饭。	 wǒ gāng chīwán fàn。 	(完: wán) I just finished eating.
你的判断完全正确。	 nǐ de pànduàn wánquán zhèngquè。 	(完全: wánquán) Your judgment is correct.
我按时完成了任务。	 wǒ ànshí wánchéng le rènwu。 	(完成: wánchéng) I completed the mission.
我们提前完成了任务。	 wǒmen tíqián wánchéng le rènwu。 	(完成: wánchéng) We are ahead of schedule.
任务完成百分之八十了。	 rènwu wánchéng bǎifēnzhī bāshí le。 	(完成: wánchéng) Eighty percent of the task is completed.
宝宝，亲一下爸爸。	 bǎobǎo， qīn yīxià bàba。 	(宝宝: bǎobǎo) Baby, give your dad a kiss.
宝宝刚起床。	 bǎobǎo gāng qǐchuáng。 	(宝宝: bǎobǎo) The baby just woke up.
宝宝刚才笑了。	 bǎobǎo gāngcái xiào le。 	(宝宝: bǎobǎo) The baby just now laughed.
宝宝在床上。	 bǎobǎo zài chuáng shàng。 	(宝宝: bǎobǎo) The baby is on the bed.
宝宝已经会说话了。	 bǎobǎo yǐjīng huì shuōhuà le。 	(宝宝: bǎobǎo) The baby can already speak.
宝宝没哭。	 bǎobǎo méi kū。 	(宝宝: bǎobǎo) The baby didn't cry.
宝宝没有哭。	 bǎobǎo méiyǒu kū。 	(宝宝: bǎobǎo) The baby didn't cry.
宝宝要睡觉。	 bǎobǎo yào shuìjiào。 	(宝宝: bǎobǎo) The baby wants to sleep.
可爱的宝宝	 kě'ài de bǎobǎo 	(宝宝: bǎobǎo) A cute baby.
我们热情地欢迎客人。	 wǒmen rèqíng dì huānyíng kèrén。 	(客人: kèrén) We warmly welcome guests.
不客气。	 bùkèqi。 	(客气: kèqì) you're welcome; don't be polite
不客气。	 bùkèqi。 	(客气: kèqì) You are welcome.
不客气。	 bùkèqi。 	(客气: kèqì) You're welcome.
儿子非常害怕打针。	 érzi fēicháng hàipà dǎzhēn。 	(害怕: hàipà) Son very afraid of injections.
这个孩子怎么不害羞？	 zhège háizi zěnme bù hàixiū？ 	(害羞: hàixiū) Why is this child not shy?
这个孩子怎么这么害羞？	 zhège háizi zěnme zhème hàixiū？ 	(害羞: hàixiū) How can this little girl be so shy?
这个问题很容易回答。	 zhège wèntí hěn róngyì huídá。 	(容易: róngyì) This question is easy to answer.
有多宽？	 yǒu duō kuān？ 	(宽: kuān) How wide is it?
人们的生活越来越富。	 rénmen de shēnghuó yuèláiyuè fù。 	(富: fù) People's lives richer.
对、对不起。	 duì、 duìbuqǐ。 	(对: duì) You're right, I'm sorry.
经理对他很满意。	 jīnglǐ duì tā hěn mǎnyì。 	(对: duì) The manager he was very satisfied.
我对他很失望。	 wǒ duì tā hěn shīwàng。 	(对: duì) I told him very disappointed.
这样做，对吗？	 zhèyàng zuò， duì ma？ 	(对: duì) Like this, right?
对啊！	 duì ā！ 	(对: duì) You're right!
这是对的。	 zhè shì duì de。 	(对: duì) That's true.
这个菜很对胃口。	 zhège cài hěn duìwèikǒu。 	(对: duì) This dish is tasty.
对不起，我爱你。	 duìbuqǐ， wǒ ài nǐ。 	(对不起: duìbùqǐ) I'm sorry, I love you.
对不起，我错了。	 duìbuqǐ， wǒ cuò le。 	(对不起: duìbùqǐ) I'm sorry, I was wrong.
对、对不起。	 duì、 duìbuqǐ。 	(对不起: duìbùqǐ) You're right, I'm sorry.
对不起我来晚了。	 duìbuqǐ wǒ lái wǎn le。 	(对不起: duìbùqǐ) Sorry to be late.
对不起打扰你了。	 duìbuqǐ dǎrǎo nǐ le。 	(对不起: duìbùqǐ) I'm sorry to bother you.
你何时将回日本?。	 nǐ héshí jiāng huí Rìběn?。 	(将: jiāng) When will you go back to Japan?
我将等到四点钟。	 wǒ jiāng děngdào sì diǎnzhōng。 	(将: jiāng) I'll wait until four o'clock.
将近三点了。	 jiāngjìn sān diǎn le。 	(将近: jiāngjìn) It's nearly three o'clock.
李小姐很漂亮。	 lǐ xiǎojie hěn piàoliang。 	(小姐: xiǎojiě) Miss Lee is very pretty.
八十个小孩	 bāshí gè xiǎohái 	(小孩: xiǎohái) eighty children
小孩子不可以看这个。	 xiǎoháizi bùkěyǐ kàn zhège。 	(小孩子: xiǎoháizi) Young children can't watch this.
小李比小张更高。	 xiǎo lǐ bǐ xiǎo zhāng gèng gāo。 	(小张: xiǎozhāng) Xiao Li is even taller than Xiao Zhang.
小张比小李矮。	 xiǎo zhāng bǐ xiǎo lǐ ǎi。 	(小张: xiǎozhāng) Xiao Zhang is smaller than Xiao Li.
小李没有小张矮。	 xiǎo lǐ méiyǒu xiǎo zhāng ǎi。 	(小张: xiǎozhāng) Xiao Li is not as short as Xiao Zhang.
小李比小张高。	 xiǎo lǐ bǐ xiǎo zhāng gāo。 	(小张: xiǎozhāng) Xiao Li is taller than Xiao Zhang.
我等了五个小时。	 wǒděng le wǔ gè xiǎoshí。 	(小时: xiǎoshí) I waited for five hours.
老板说了一个小时。	 lǎobǎn shuō le yī gè xiǎoshí。 	(小时: xiǎoshí) The boss spoke an hour.
已经半个小时了。	 yǐjīng bànge xiǎoshí le。 	(小时: xiǎoshí) It has already been half an hour.
半个小时	 bànge xiǎoshí 	(小时: xiǎoshí) half an hour
我是小李。	 wǒ shì xiǎo lǐ。 	(小李: xiǎolǐ) I am Xiao Li.
小李工作非常负责。	 xiǎo lǐ gōngzuò fēicháng fùzé。 	(小李: xiǎolǐ) Mike is very responsible job.
小李比小张高。	 xiǎo lǐ bǐ xiǎo zhāng gāo。 	(小李: xiǎolǐ) Xiao Li is taller than Xiao Zhang.
小李比小张更高。	 xiǎo lǐ bǐ xiǎo zhāng gèng gāo。 	(小李: xiǎolǐ) Xiao Li is even taller than Xiao Zhang.
小李没有小张矮。	 xiǎo lǐ méiyǒu xiǎo zhāng ǎi。 	(小李: xiǎolǐ) Xiao Li is not as short as Xiao Zhang.
小李的房子	 xiǎo lǐ de fángzi 	(小李: xiǎolǐ) Xiaoli's house
小李的手机	 xiǎo lǐ de shǒujī 	(小李: xiǎolǐ) Xiao Li's cell phone
小张比小李矮。	 xiǎo zhāng bǐ xiǎo lǐ ǎi。 	(小李: xiǎolǐ) Xiao Zhang is smaller than Xiao Li.
张没有小李高。	 zhāng méiyǒu xiǎo lǐ gāo。 	(小李: xiǎolǐ) Xiao Zhang is not as tall as Xiao Li.
现在就做。	 xiànzài jiù zuò。 	(就: jiù) Do it now.
现在就做。	 xiànzài jiù zuò。 	(就: jiù) Do it now.
我从小就爱好音乐。	 wǒ cóngxiǎo jiù àihào yīnyuè。 	(就: jiù) I grew up loving music.
明天就要放暑假了。	 míngtiān jiùyào fàng shǔjià le。 	(就要: jiùyào) Tomorrow the summer holidays.
会议马上就要结束了。	 huìyì mǎshàng jiùyào jiéshù le。 	(就要: jiùyào) Conference coming to an end.
飞机马上就要降落了。	 fēijī mǎshàng jiùyào jiàngluò le。 	(就要: jiùyào) Aircraft soon landed.
尽早做。	 jǐnzǎo zuò。 	(尽早: jǐnzǎo) Do it as soon as possible.
尽早来。	 jǐnzǎo lái。 	(尽早: jǐnzǎo) Come as soon as possible.
尾翼飞机的尾部。	 wěiyì fēijī de wěibù。 	(尾翼: wěiyì) The tail of an airplane.
尾翼飞机的尾部。	 wěiyì fēijī de wěibù。 	(尾部: wěibù) The tail of an airplane.
药局在医院附近。	 yàojú zài yīyuàn fùjìn。 	(局: jú) The pharmacy is near the hospital.
男厕所在一层。	 náncè suǒzài yīcéng。 	(层: céng) The men's room on the first floor.
我来自山东省。	 wǒ láizì Shāndōng Shěng。 	(山东省: shāndōngshěng) I come from Shandong province.
海伦十七岁。	 Hǎilún shíqī suì。 	(岁: suì) Helen is seventeen years old.
我明年17岁。	 wǒ míngnián17 suì。 	(岁: suì) I'll be seventeen next year.
李医生今年40岁。	 lǐ yīshēng jīnnián40 suì。 	(岁: suì) Dr. Li 40 years old this year.
你儿子几岁?。	 nǐ érzi jǐsuì?。 	(岁: suì) How old is your son?
她十七岁了。	 tā shíqī suì le。 	(岁: suì) She's seventeen years old.
我25岁了。	 wǒ25 suì le。 	(岁: suì) I'm 25 years old.
今天我四岁了。	 jīntiān wǒ sì suì le。 	(岁: suì) Today I turn four years old.
我儿子三岁了。	 wǒ érzi sān suì le。 	(岁: suì) My son is three years old.
你已经十五岁了。	 nǐ yǐjīng shíwǔ suì le。 	(岁: suì) You are already fifteen years old.
十八岁以后可以喝酒。	 shíbā suì yǐhòu kěyǐ hējiǔ。 	(岁: suì) After you are 18 years old you may drink alcohol.
海里有岛。	 hǎilǐ yǒu dǎo。 	(岛: dǎo) There are islands in the sea.
我不工作.。	 wǒ bù gōngzuò.。 	(工作: gōngzuò) I do not work.
她继续工作。	 tā jìxù gōngzuò。 	(工作: gōngzuò) She kept on working.
我继续工作。	 wǒ jìxù gōngzuò。 	(工作: gōngzuò) I continued working.
我正在工作。	 wǒ zhèngzài gōngzuò。 	(工作: gōngzuò) I'm working right now.
她继续工作。	 tā jìxù gōngzuò。 	(工作: gōngzuò) She went on working.
我没有工作。	 wǒ méiyǒu gōngzuò。 	(工作: gōngzuò) I don't have a job.
我没工作。	 wǒ méi gōngzuò。 	(工作: gōngzuò) I don't have a job.
他刚工作。	 tā gāng gōngzuò。 	(工作: gōngzuò) He just started working.
我要工作。	 wǒ yào gōngzuò。 	(工作: gōngzuò) I want to work.
我为你工作。	 wǒ wéi nǐ gōngzuò。 	(工作: gōngzuò) I work for you.
我在医院工作。	 wǒ zài yīyuàn gōngzuò。 	(工作: gōngzuò) I work in a hospital.
我在医院工作。	 wǒ zài yīyuàn gōngzuò。 	(工作: gōngzuò) I work in a hospital.
我不想工作。	 wǒ bùxiǎng gōngzuò。 	(工作: gōngzuò) I don't want to work.
我在上海工作。	 wǒ zài Shàng Hǎi gōngzuò。 	(工作: gōngzuò) I am working in Shanghai.
他想在医院工作。	 tā xiǎng zài yīyuàn gōngzuò。 	(工作: gōngzuò) He wants to work in a hospital.
我丈夫在医院工作。	 wǒ zhàngfu zài yīyuàn gōngzuò。 	(工作: gōngzuò) My husband works in a hospital.
他想找一个工作。	 tā xiǎng zhǎo yī gè gōngzuò。 	(工作: gōngzuò) He tried to find a job.
我太太现在没有工作。	 wǒ tàitai xiànzài méiyǒu gōngzuò。 	(工作: gōngzuò) My wife doesn't have a job right now.
我和他一起工作。	 wǒ hé tā yīqǐ gōngzuò。 	(工作: gōngzuò) He and I work together.
很多人都想工作。	 hěn duō rén dōu xiǎng gōngzuò。 	(工作: gōngzuò) A lot of people want to work.
我在这个公司工作。	 wǒ zài zhège gōngsī gōngzuò。 	(工作: gōngzuò) I work at this company.
他刚工作一年。	 tā gāng gōngzuò yī nián。 	(工作: gōngzuò) He just worked a year.
我没有工作了。	 wǒ méiyǒu gōngzuò le。 	(工作: gōngzuò) I don't have a job anymore.
你有工作吗？	 nǐ yǒu gōngzuò ma？ 	(工作: gōngzuò) Do you have a job?
工作差不多做完了。	 gōngzuò chàbuduō zuò wánle。 	(工作: gōngzuò) Work is almost over.
爸爸的工作很辛苦。	 bàba de gōngzuò hěn xīnkǔ。 	(工作: gōngzuò) Dad's job very hard.
工作还算顺利。	 gōngzuò hái suàn shùnlì。 	(工作: gōngzuò) The work is fairly smooth.
小李工作非常负责。	 xiǎo lǐ gōngzuò fēicháng fùzé。 	(工作: gōngzuò) Mike is very responsible job.
我要吃巧克力。	 wǒ yào chī qiǎokèlì。 	(巧克力: qiǎokèlì) I want to eat chocolate.
巧克力也是。	 qiǎokèlì yě shì。 	(巧克力: qiǎokèlì) Chocolate is too. / Chocolate too.
六块巧克力	 liù kuài qiǎokèlì 	(巧克力: qiǎokèlì) six pieces of chocolate
一块巧克力	 yīkuài qiǎokèlì 	(巧克力: qiǎokèlì) a piece of chocolate
一盒巧克力	 yī hé qiǎokèlì 	(巧克力: qiǎokèlì) a box of chocolate
一颗巧克力	 yī kē qiǎokèlì 	(巧克力: qiǎokèlì) a small piece of chocolate
那块巧克力	 nà kuài qiǎokèlì 	(巧克力: qiǎokèlì) that piece of chocolate
差一分十二点	 chà yī fēn shí'èr diǎn 	(差: chà) one minute til 12 o'clock
差一刻五点	 chà yī kè wǔ diǎn 	(差: chà) fifteen minutes til 5 o'clock
差两分五点	 chà liǎng fēn wǔ diǎn 	(差: chà) two minutes til 5 o'clock
差二十分十二点	 chà èrshí fēn shí'èr diǎn 	(差: chà) twenty minutes til 12 o'clock
差五分三点	 chà wǔ fēn sān diǎn 	(差: chà) three minutes til 3 o'clock
差五分八点半	 chà wǔ fēn bā diǎn bàn 	(差: chà) five minutes til 8:30
差八分八点	 chà bā fēn bā diǎn 	(差: chà) eight minutes til 8 o'clock
差十五分十点	 chà shíwǔ fēn shí diǎn 	(差: chà) fifteen minutes til 10 o'clock
差十分两点	 chà shífēn liǎng diǎn 	(差: chà) ten minutes til 2 o'clock
差十分十点半	 chà shífēn shí diǎn bàn 	(差: chà) ten minutes til 10:30
他们的年龄差不多。	 tāmen de niánlíng chàbuduō。 	(差不多: chàbùduō) Their ages are more or less the same.
我们的想法差不多。	 wǒmen de xiǎngfǎ chàbuduō。 	(差不多: chàbùduō) Our ways of thinking are pretty much the same.
上海和纽约差不多。	 Shàng Hǎi hé Niǔyuē chàbuduō。 	(差不多: chàbùduō) Shanghai and New York are basically the same.
这里的房间都差不多。	 zhèlǐ de fángjiān dōu chàbuduō。 	(差不多: chàbùduō) The rooms here are all basically the same.
这两个电脑差不多。	 zhè liǎng gè diànnǎo chàbuduō。 	(差不多: chàbùduō) These two computers are almost the same.
我们的中文水平差不多。	 wǒmen de Zhōngwén shuǐpíng chàbuduō。 	(差不多: chàbùduō) Our levels of Chinese are more or less the same.
工作差不多做完了。	 gōngzuò chàbuduō zuò wánle。 	(差不多: chàbùduō) Work is almost over.
北京和上海差不多热。	 Běijīng hé Shàng Hǎi chàbuduō rè。 	(差不多: chàbùduō) Beijing and Shanghai are both just as hot.
我们有差不多的想法。	 wǒmen yǒu chàbuduōde xiǎngfǎ。 	(差不多: chàbùduō) We have more or less the same way of thinking.
我们有差不多的电脑。	 wǒmen yǒu chàbuduōde diànnǎo。 	(差不多: chàbùduō) We have more or less the same computer.
我们喜欢差不多的菜。	 wǒmen xǐhuan chàbuduōde cài。 	(差不多: chàbùduō) We like more or less the same food.
两个地方差不多远。	 liǎng gè dìfang chàbuduō yuǎn。 	(差不多: chàbùduō) The two places are both just as far away.
我们差不多高。	 wǒmen chàbuduō gāo。 	(差不多: chàbùduō) We are more or less the same height.
现在已经七点。	 xiànzài yǐjīng qī diǎn。 	(已经: yǐjīng) It's already seven.
我已经上飞机了。	 wǒ yǐjīng shàng fēijī le。 	(已经: yǐjīng) I have already been on a plane.
你已经不年轻了。	 nǐ yǐjīng bù niánqīng le。 	(已经: yǐjīng) You're not young anymore.
面包已经买了。	 miànbāo yǐjīng mǎi le。 	(已经: yǐjīng) Already bought the bread.
宝宝已经会说话了。	 bǎobǎo yǐjīng huì shuōhuà le。 	(已经: yǐjīng) The baby can already speak.
我们已经做完了。	 wǒmen yǐjīng zuò wánle。 	(已经: yǐjīng) We have already finished it.
我已经做完了。	 wǒ yǐjīng zuò wánle。 	(已经: yǐjīng) I already finished it.
他已经做出了决定。	 tā yǐjīng zuòchū le juédìng。 	(已经: yǐjīng) He has made a decision.
已经六点钟了。	 yǐjīng liù diǎnzhōng le。 	(已经: yǐjīng) It's six o'clock already.
他们已经到酒吧了。	 tāmen yǐjīng dào jiǔbā le。 	(已经: yǐjīng) They already got to the bar.
已经十分钟了。	 yǐjīng shífēn zhōng le。 	(已经: yǐjīng) It has already been 10 minutes.
你已经十五岁了。	 nǐ yǐjīng shíwǔ suì le。 	(已经: yǐjīng) You are already fifteen years old.
已经半个小时了。	 yǐjīng bànge xiǎoshí le。 	(已经: yǐjīng) It has already been half an hour.
面包已经卖完了。	 miànbāo yǐjīng mài wánle。 	(已经: yǐjīng) Bread has been sold out.
我已经吃饱了。	 wǒ yǐjīng chībǎo le。 	(已经: yǐjīng) I've had enough.
我已经吃饭了。	 wǒ yǐjīng chīfàn le。 	(已经: yǐjīng) I already ate.
我已经告诉他了。	 wǒ yǐjīng gàosu tā le。 	(已经: yǐjīng) I've already told him.
他已经回来了。	 tā yǐjīng huílai le。 	(已经: yǐjīng) He already came back.
已经学过了。	 yǐjīng xué guò le。 	(已经: yǐjīng) Already studied it.
已经很便宜了。	 yǐjīng hěn piányi le。 	(已经: yǐjīng) It is already very cheap.
我们已经很忙了。	 wǒmen yǐjīng hěn máng le。 	(已经: yǐjīng) We are already very busy.
你已经很漂亮了。	 nǐ yǐjīng hěn piàoliang le。 	(已经: yǐjīng) You are already very beautiful.
我已经很烦了。	 wǒ yǐjīng hěn fán le。 	(已经: yǐjīng) I am already very tired.
已经很长时间了。	 yǐjīng hěn cháng shíjiān le。 	(已经: yǐjīng) It has already been a long time.
我已经改变了计划。	 wǒ yǐjīng gǎibiàn le jìhuà。 	(已经: yǐjīng) I have changed plans.
今天已经星期五了。	 jīntiān yǐjīng Xīngqīwǔ le。 	(已经: yǐjīng) Today is already Friday.
已经是时候回去了。	 yǐjīng shì shíhou huíqu le。 	(已经: yǐjīng) It's already time to go home.
已经晚了。	 yǐjīng wǎn le。 	(已经: yǐjīng) It's already late.
我已经有男朋友了。	 wǒ yǐjīng yǒu nánpéngyou le。 	(已经: yǐjīng) I already have a boyfriend.
你已经知道了。	 nǐ yǐjīng zhīdàole。 	(已经: yǐjīng) You knew
已经给你了。	 yǐjīng gěi nǐ le。 	(已经: yǐjīng) Already gave it to you.
爸爸妈妈已经老了。	 bàba māma yǐjīng lǎo le。 	(已经: yǐjīng) Mom and dad are already old.
他已经走了。	 tā yǐjīng zǒu le。 	(已经: yǐjīng) He has already left.
已经过了五点钟。	 yǐjīng guò le wǔ diǎnzhōng。 	(已经: yǐjīng) It is already past five o'clock.
我已经通过了考试。	 wǒ yǐjīng tōngguò le kǎoshì。 	(已经: yǐjīng) I have passed the exam.
我已经饿了。	 wǒ yǐjīng è le。 	(已经: yǐjīng) I am already hungry.
天已经黑了。	 tiān yǐjīng hēi le。 	(已经: yǐjīng) It is already dark.
书巳出版。	 shū sì chūbǎn。 	(巳: sì) The book is out.
巴士早了两分钟。	 bāshì zǎo le liǎng fēnzhōng。 	(巴士: bāshì) The bus was two minutes early.
这块布料染的不好。	 zhè kuài bùliào rǎn de bùhǎo。 	(布料: bùliào) This piece of cloth has bad coloration.
他又高又帅。	 tā yòu gāo yòu shuài。 	(帅: shuài) He is both tall and handsome.
那个帅哥姓张。	 nàge shuàigē xìng zhāng。 	(帅: shuài) That handsome guy's last name is Zhang.
我希望会看见她。	 wǒ xīwàng huì kànjiàn tā。 	(希望: xīwàng) I hope that I'll see her.
请结帐。	 qǐng jiézhàng。 	(帐: zhàng) Check, please.
谁躲在帘子后面？	 shéi duǒ zài liánzi hòumian？ 	(帘子: liánzi) Who is hiding behind the curtain?
我今天忘记带钥匙。	 wǒ jīntiān wàngjì dài yàoshi。 	(带: dài) I forgot to bring the key today.
我能帮你。	 wǒ néng bāng nǐ。 	(帮: bāng) I can help you.
我没办法帮你。	 wǒ méibànfǎ bāng nǐ。 	(帮: bāng) I have no way to help you.
请帮我。	 qǐng bāng wǒ。 	(帮: bāng) Please help me.
你能帮我吗?	 nǐ néng bāng wǒ ma? 	(帮: bāng) Could you help me?
我们需要一些帮助。	 wǒmen xūyào yīxiē bāngzhù。 	(帮助: bāngzhù) We need some help.
他很愿意帮助别人。	 tā hěn yuànyì bāngzhù biéren。 	(帮助: bāngzhù) He was very willing to help others.
我能帮助她。	 wǒ néng bāngzhù tā。 	(帮助: bāngzhù) I was able to help her.
我去请老师帮忙。	 wǒ qù qǐng lǎoshī bāngmáng。 	(帮忙: bāngmáng) I went to ask the teacher for help.
衣服快干了。	 yīfu kuài gàn le。 	(干: gàn) The clothes are almost clean.
她平时很少运动。	 tā píngshí hěn shǎo yùndòng。 	(平时: píngshí) She rarely exercise.
1868年1月18号	 1868 nián1 yuè18 hào 	(年: nián) January 18, 1868
1973年7月20日	 1973 nián7 yuè20 rì 	(年: nián) 20-Jul-73
1910年8月9号	 1910 nián8 yuè9 hào 	(年: nián) 09-Aug-10
1940年11月27日	 1940 nián11 yuè27 rì 	(年: nián) 14942
他刚工作一年。	 tā gāng gōngzuò yī nián。 	(年: nián) He just worked a year.
我们结婚10年了。	 wǒmen jiéhūn10 nián le。 	(年: nián) We've been married 10 years.
他七年前来日本。	 tā qī niánqián láirì běn。 	(年: nián) He came to Japan seven years ago.
我两年前来日本。	 wǒ liǎng niánqián láirì běn。 	(年: nián) I came to Japan two years ago.
他两年前来日本。	 tā liǎng niánqián láirì běn。 	(年: nián) He came to Japan two years ago.
他七年前来日本。	 tā qī niánqián láirì běn。 	(年: nián) He came to Japan seven years ago.
一年半	 yīniánbàn 	(年: nián) a year and a half
四年半	 sì nián bàn 	(年: nián) four and a half years
你已经不年轻了。	 nǐ yǐjīng bù niánqīng le。 	(年轻: niánqīng) You're not young anymore.
很多年轻人不运动。	 hěn duō niánqīngrén bù yùndòng。 	(年轻人: niánqīngrén) Many young people don't exercise.
他们的年龄差不多。	 tāmen de niánlíng chàbuduō。 	(年龄: niánlíng) Their ages are more or less the same.
我生活得很幸福。	 wǒ shēnghuó dehěn xìngfú。 	(幸福: xìngfú) I live a happy life.
钱买不来幸福。	 qián mǎi bù lái xìngfú。 	(幸福: xìngfú) Money can not buy happiness.
李教授说话非常幽默。	 lǐ jiàoshòu shuōhuà fēicháng yōumò。 	(幽默: yōumò) Professor Lee spoke very humorous.
爷爷正在听广播。	 yéye zhèngzài tīng guǎngbō。 	(广播: guǎngbò) Grandpa is listening to the radio.
他总是很早起床。	 tā zǒngshì hěn zǎo qǐchuáng。 	(床: chuáng) He always got up very early.
宝宝在床上。	 bǎobǎo zài chuáng shàng。 	(床: chuáng) The baby is on the bed.
她应该中午到那里。	 tā yīnggāi zhōngwǔ dào nàli。 	(应该: yīnggāi) She should be there at noon.
人们应该保护环境。	 rénmen yīnggāi bǎohù huánjìng。 	(应该: yīnggāi) People should protect the environment.
我应该去他家吗？	 wǒ yīnggāi qù tā jiā ma？ 	(应该: yīnggāi) Should I go to his house?
他应该去看医生。	 tā yīnggāi qù kàn yīshēng。 	(应该: yīnggāi) He should go to see a doctor.
我想应该可以吧。	 wǒ xiǎng yīnggāi kěyǐ ba。 	(应该: yīnggāi) I think it should be OK.
你应该告诉我。	 nǐ yīnggāi gàosu wǒ。 	(应该: yīnggāi) You should tell me.
我应该喝点水。	 wǒ yīnggāi hē diǎnshuǐ。 	(应该: yīnggāi) I should drink a little water.
你应该多吃点。	 nǐ yīnggāi duō chī diǎn。 	(应该: yīnggāi) You should eat a little more.
你应该学汉语。	 nǐ yīnggāi xué Hànyǔ。 	(应该: yīnggāi) You should study Chinese.
我们应该怎么告诉他？	 wǒmen yīnggāi zěnme gàosu tā？ 	(应该: yīnggāi) How should we tell him?
你不应该总是抱怨。	 nǐ bù yīnggāi zǒngshì bàoyuàn。 	(应该: yīnggāi) You shouldn't always complain.
应该是吧。	 yīnggāi shì ba。 	(应该: yīnggāi) It should be. [referring to some context]
他应该洗澡。	 tā yīnggāi xǐzǎo。 	(应该: yīnggāi) He should take a shower.
你应该看这个电影。	 nǐ yīnggāi kàn zhège diànyǐng。 	(应该: yīnggāi) You should watch this movie.
大家都应该知道。	 dàjiā dōu yīnggāi zhīdào。 	(应该: yīnggāi) Everyone should know.
我应该说英文吗？	 wǒ yīnggāi shuō Yīngwén ma？ 	(应该: yīnggāi) Should I speak English?
猫在桌子底下。	 māo zài zhuōzi dǐxia。 	(底下: dǐxia) The cat is under the table.
金字塔是古时候建造的。	 jīnzìtǎ shì gǔshíhou jiànzào de。 	(建造: jiànzào) The pyramids were built in ancient times.
课程八点半开始。	 kèchéng bā diǎn bàn kāishǐ。 	(开始: kāishǐ) The class begins at 8:30.
现在比赛正式开始。	 xiànzài bǐsài zhèngshì kāishǐ。 	(开始: kāishǐ) Now the race begins.
八点半开始上课。	 bā diǎn bàn kāishǐ shàngkè。 	(开始: kāishǐ) Class doesn't begin until eight-thirty.
会议准时开始了。	 huìyì zhǔnshí kāishǐ le。 	(开始: kāishǐ) Meeting started on time.
霜还没有开始溶化。	 shuāng hái méiyǒu kāishǐ rónghuà。 	(开始: kāishǐ) The hoarfrost has not begun to thaw yet.
你是在开玩笑吧？	 nǐ shì zài kāiwánxiào ba？ 	(开玩笑: kāiwánxiào) Are you kidding?
他是我弟弟。	 tā shì wǒ dìdi。 	(弟弟: dìdì) He's my younger brother.
弟弟正在打篮球。	 dìdi zhèngzài dǎ lánqiú。 	(弟弟: dìdì) Brother playing basketball.
我姓张。	 wǒ xìng zhāng。 	(张: zhāng) I Zhang.
那个帅哥姓张。	 nàge shuàigē xìng zhāng。 	(张: zhāng) That handsome guy's last name is Zhang.
这张桌子	 zhè zhāng zhuōzi 	(张: zhāng) this table
张没有小李高。	 zhāng méiyǒu xiǎo lǐ gāo。 	(张: zhāng) Xiao Zhang is not as tall as Xiao Li.
你需要几张纸？	 nǐ xūyào jǐ zhāng zhǐ？ 	(张: zhāng) How many pieces of paper do you need??
把嘴张开！	 bǎ zuǐ zhāngkāi！ 	(张开: zhāngkāi) Open your mouth!
张开眼睛。	 zhāngkāi yǎnjing。 	(张开: zhāngkāi) Open your eyes.
我当过老师。	 wǒ dāng guò lǎoshī。 	(当: dāng) I was a teacher.
请不要影响别人休息。	 qǐng bùyào yǐngxiǎng biéren xiūxi。 	(影响: yǐngxiǎng) Please do not influence others to rest.
商店在学校很。	 shāngdiàn zài xuéxiào hěn。 	(很: hěn) Stores in the school lot.
我很不高兴。	 wǒ hěn bù gāoxìng。 	(很: hěn) I am not happy.
这把椅子很丑。	 zhè bǎ yǐzi hěn chǒu。 	(很: hěn) This chair is ugly.
你很了解中国。	 nǐ hěn liǎojiě Zhōngguó。 	(很: hěn) You really understand China.
我现在很伤心。	 wǒ xiànzài hěn shāngxīn。 	(很: hěn) Now, I am very sad.
已经很便宜了。	 yǐjīng hěn piányi le。 	(很: hěn) It is already very cheap.
今天很冷。	 jīntiān hěn lěng。 	(很: hěn) It's cold today.
天很冷。	 tiān hěn lěng。 	(很: hěn) It's cold.
今天很冷。	 jīntiān hěn lěng。 	(很: hěn) It's cold today.
北方的冬天很冷。	 běifāng de dōngtiān hěn lěng。 	(很: hěn) Cold northern winter.
秋天的天气很凉快。	 qiūtiān de tiānqì hěn liángkuai。 	(很: hěn) Autumn weather is very cool.
学生们学习很努力。	 xuésheng men xuéxí hěn nǔlì。 	(很: hěn) The students study very hard.
那很可笑。	 nà hěn kěxiào。 	(很: hěn) That will be funny.
我都很同情他。	 wǒ dōu hěn tóngqíng tā。 	(很: hěn) I am very sorry for him.
这部电影很吸引人。	 zhè bù diànyǐng hěn xīyǐn rén。 	(很: hěn) The film is very attractive.
她一直很喜欢上海。	 tā yīzhí hěn xǐhuan Shàng Hǎi。 	(很: hěn) She has always liked Shanghai a lot.
我很喜欢他。	 wǒ hěn xǐhuan tā。 	(很: hěn) I really like him.
我很喜欢体育运动。	 wǒ hěn xǐhuan tǐyùyùndòng。 	(很: hěn) I love sports.
女儿很喜欢小狗。	 nǚ'ér hěn xǐhuan xiǎogǒu。 	(很: hěn) Daughter liked the dog.
我很喜欢电影。	 wǒ hěn xǐhuan diànyǐng。 	(很: hěn) I like movies a lot.
以前她很喜欢笑。	 yǐqián tā hěn xǐhuan xiào。 	(很: hěn) Before, she really liked laughing.
她以前很喜欢笑。	 tā yǐqián hěn xǐhuan xiào。 	(很: hěn) Before, she really liked laughing.
他很喜欢说话。	 tā hěn xǐhuan shuōhuà。 	(很: hěn) He really likes to talk
我们都很喜欢运动。	 wǒmen dōu hěn xǐhuan yùndòng。 	(很: hěn) We liked sports.
他很坏。	 tā hěn huài。 	(很: hěn) He's bad.
我家很大。	 wǒ jiā hěn dà。 	(很: hěn) My house is very big.
大象很大。	 dàxiàng hěn dà。 	(很: hěn) The elephant is big.
这个苹果很大。	 zhège píngguǒ hěn dà。 	(很: hěn) The big apple.
我们学校很大。	 wǒmen xuéxiào hěn dà。 	(很: hěn) Our school great.
我们学校很大。	 wǒmen xuéxiào hěn dà。 	(很: hěn) Our school is big.
我对他很失望。	 wǒ duì tā hěn shīwàng。 	(很: hěn) I told him very disappointed.
很好，谢谢。	 hěn hǎo， xièxie。 	(很: hěn) Fine, thanks.
我很好，谢谢。	 wǒ hěn hǎo， xièxie。 	(很: hěn) I'm very well, thank you.
我很好。	 wǒ hěn hǎo。 	(很: hěn) I'm good.
今天天气很好。	 jīntiān tiānqì hěn hǎo。 	(很: hěn) The weather today is good.
我一切都很好。	 wǒ yīqiè dōu hěn hǎo。 	(很: hěn) I am quite all right now.
三明治很好做。	 sānmíngzhì hěn hǎo zuò。 	(很: hěn) Sandwiches are easy to make.
这个汉字很好写。	 zhège hànzì hěn hǎo xiě。 	(很: hěn) This Chinese character is easy to write.
日本菜也很好吃。	 Rìběn cài yě hěn hǎochī。 	(很: hěn) Japanese food is also very delicious.
这首歌很好听。	 zhè shǒugē hěn hǎotīng。 	(很: hěn) This song is great.
这种酒也很好喝。	 zhèzhǒng jiǔ yě hěn hǎohē。 	(很: hěn) This kind of alcohol is also very good.
这本书很好懂。	 zhè běn shū hěn hǎo dǒng。 	(很: hěn) This book is easy to understand.
我觉得上海很好玩。	 wǒ juéde Shàng Hǎi hěn hǎowán。 	(很: hěn) I think Shanghai is a lot of fun.
你很好看。	 nǐ hěn hǎokàn。 	(很: hěn) You are good-looking.
这件衣服很好看。	 zhè jiàn yīfu hěn hǎokàn。 	(很: hěn) This piece of clothing looks good.
这个问题很容易回答。	 zhège wèntí hěn róngyì huídá。 	(很: hěn) This question is easy to answer.
这个菜很对胃口。	 zhège cài hěn duìwèikǒu。 	(很: hěn) This dish is tasty.
猫很小。	 māo hěn xiǎo。 	(很: hěn) The cat is small.
这本书很小。	 zhè běn shū hěn xiǎo。 	(很: hěn) This book is very small.
这本书很小。	 zhè běn shū hěn xiǎo。 	(很: hěn) This book is very small.
你的胸很小。	 nǐ de xiōng hěn xiǎo。 	(很: hěn) You have a small chest.
她平时很少运动。	 tā píngshí hěn shǎo yùndòng。 	(很: hěn) She rarely exercise.
我生活得很幸福。	 wǒ shēnghuó dehěn xìngfú。 	(很: hěn) I live a happy life.
笑得很开心	 xiào dehěn kāixīn 	(很: hěn) Laugh happily
她很忙。	 tā hěn máng。 	(很: hěn) She's busy.
我很忙。	 wǒ hěn máng。 	(很: hěn) I am very busy.
我今天很忙。	 wǒ jīntiān hěn máng。 	(很: hěn) I'm very busy today.
我爸爸很忙。	 wǒ bàba hěn máng。 	(很: hěn) My father is busy.
我昨天很忙。	 wǒ zuótiān hěn máng。 	(很: hěn) I was very busy yesterday.
我最近很忙。	 wǒ zuìjìn hěn máng。 	(很: hěn) I recently busy.
星期二我很忙。	 Xīngqī'èr wǒ hěn máng。 	(很: hěn) I am busy on Tuesday.
我一直很忙。	 wǒ yīzhí hěn máng。 	(很: hěn) I am always very busy.
我们已经很忙了。	 wǒmen yǐjīng hěn máng le。 	(很: hěn) We are already very busy.
以前我很快乐。	 yǐqián wǒ hěn kuàilè。 	(很: hěn) Before, I was very happy.
我以前很快乐。	 wǒ yǐqián hěn kuàilè。 	(很: hěn) Before, I was very happy.
我们很急。	 wǒmen hěn jí。 	(很: hěn) We're in a hurry.
我很想去法国。	 wǒ hěn xiǎng qù Fǎguó。 	(很: hěn) I would really like to go to France.
他很愿意帮助别人。	 tā hěn yuànyì bāngzhù biéren。 	(很: hěn) He was very willing to help others.
我们走得很慢。	 wǒmen zǒu dehěn màn。 	(很: hěn) We walked slowly.
他总是很早起床。	 tā zǒngshì hěn zǎo qǐchuáng。 	(很: hěn) He always got up very early.
这个小朋友很有礼貌。	 zhège xiǎopéngyǒu hěn yǒulǐmào。 	(很: hěn) The child was very polite.
这本书很有名。	 zhè běn shū hěn yǒumíng。 	(很: hěn) This book is well known.
他们儿子很有名。	 tāmen érzi hěn yǒumíng。 	(很: hěn) Their son is really famous.
电影很有趣。	 diànyǐng hěn yǒuqù。 	(很: hěn) The movie was interesting.
这本书很有趣。	 zhè běn shū hěn yǒuqù。 	(很: hěn) This book is very interesting.
那部电影很有趣。	 nà bù diànyǐng hěn yǒuqù。 	(很: hěn) That film's really interesting.
妈妈很注意保护皮肤。	 māma hěn zhùyì bǎohù pífū。 	(很: hěn) Mom very careful to protect the skin.
我很渴。	 wǒ hěn kě。 	(很: hěn) I'm very thirsty.
经理对他很满意。	 jīnglǐ duì tā hěn mǎnyì。 	(很: hěn) The manager he was very satisfied.
她很漂亮。	 tā hěn piàoliang。 	(很: hěn) She is beautiful.
你很漂亮。	 nǐ hěn piàoliang。 	(很: hěn) You are beautiful.
我妈妈很漂亮。	 wǒ māma hěn piàoliang。 	(很: hěn) My mother is beautiful.
李小姐很漂亮。	 lǐ xiǎojie hěn piàoliang。 	(很: hěn) Miss Lee is very pretty.
她妈妈很漂亮。	 tā māma hěn piàoliang。 	(很: hěn) Her mom is very beautiful.
你已经很漂亮了。	 nǐ yǐjīng hěn piàoliang le。 	(很: hěn) You are already very beautiful.
我已经很烦了。	 wǒ yǐjīng hěn fán le。 	(很: hěn) I am already very tired.
今天很热。	 jīntiān hěn rè。 	(很: hěn) Today is hot.
我觉得很热。	 wǒ juéde hěn rè。 	(很: hěn) I'm hot.
我一直很爱你！	 wǒ yīzhí hěn ài nǐ！ 	(很: hěn) I've always loved you a lot!
以前我很爱学习。	 yǐqián wǒ hěn ài xuéxí。 	(很: hěn) Before, I really loved studying.
我以前很爱学习。	 wǒ yǐqián hěn ài xuéxí。 	(很: hěn) Before, I really loved studying.
父母很爱我们。	 fùmǔ hěn ài wǒmen。 	(很: hěn) My parents really love us.
你很笨。	 nǐ hěn bèn。 	(很: hěn) You are stupid.
他总是很累。	 tā zǒngshì hěn lèi。 	(很: hěn) He is always tired.
这菜很美味。	 zhè cài hěn měiwèi。 	(很: hěn) This dish is tasty.
他很老。	 tā hěn lǎo。 	(很: hěn) He was very old.
我家的狗很聪明。	 wǒ jiāde gǒu hěn cōngming。 	(很: hěn) My family's dog is clever.
他也很胖。	 tā yě hěn pàng。 	(很: hěn) He is also fat.
这个椅子很舒服。	 zhège yǐzi hěn shūfu。 	(很: hěn) This chair is very comfortable.
这把椅子很舒服。	 zhè bǎ yǐzi hěn shūfu。 	(很: hěn) This chair is very comfortable.
学得很认真	 xué dehěn rènzhēn 	(很: hěn) Study seriously
小老虎很象猫。	 xiǎo lǎohǔ hěn xiàng māo。 	(很: hěn) Young tigers resemble cats.
这块手表很贵。	 zhè kuài shǒubiǎo hěn guì。 	(很: hěn) This watch is very expensive.
爸爸的工作很辛苦。	 bàba de gōngzuò hěn xīnkǔ。 	(很: hěn) Dad's job very hard.
湖南菜也很辣。	 Húnán cài yě hěn là。 	(很: hěn) Hunan food is very spicy too.
我家离学校很近。	 wǒ jiā lí xuéxiào hěn jìn。 	(很: hěn) My home is near the school.
我家离大学很近。	 wǒ jiā lí dàxué hěn jìn。 	(很: hěn) My house is close to the university.
我家离公司很近。	 wǒ jiā lí gōngsī hěn jìn。 	(很: hěn) My house is close to my office.
我家离公司很远。	 wǒ jiā lí gōngsī hěn yuǎn。 	(很: hěn) My home is far away from the company.
我家距离公司很远。	 wǒ jiā jùlí gōngsī hěn yuǎn。 	(很: hěn) My company is very far away from home.
美国离中国很远。	 Měiguó lí Zhōngguó hěn yuǎn。 	(很: hěn) America is far from China.
这台电视很重。	 zhè tái diànshì hěn zhòng。 	(很: hěn) This television is very heavy.
已经很长时间了。	 yǐjīng hěn cháng shíjiān le。 	(很: hěn) It has already been a long time.
这很难。	 zhè hěn nán。 	(很: hěn) It's very difficult.
中文很难。	 Zhōngwén hěn nán。 	(很: hěn) Chinese is difficult.
这个题很难。	 zhège tí hěn nán。 	(很: hěn) This problem is difficult.
三明治很难做。	 sānmíngzhì hěn nán zuò。 	(很: hěn) Sandwiches are hard to make.
这个汉字很难写。	 zhège hànzì hěn nán xiě。 	(很: hěn) This character is very difficult to write.
汉语很难学。	 Hànyǔ hěn nán xué。 	(很: hěn) Mandarin is hard to learn.
这首歌很难听。	 zhè shǒugē hěn nántīng。 	(很: hěn) This song is terrible
这句话很难懂。	 zhè jù huà hěn nándǒng。 	(很: hěn) This talk is hard to understand.
你姐姐很难看。	 nǐ jiějie hěn nánkàn。 	(很: hěn) Your older sister is ugly.
比赛进行得很顺利。	 bǐsài jìnxíng dehěn shùnlì。 	(很: hěn) The race went well.
我很饿。	 wǒ hěn è。 	(很: hěn) I'm very hungry.
他很高。	 tā hěn gāo。 	(很: hěn) He is very tall.
她很高。	 tā hěn gāo。 	(很: hěn) She's tall.
她爸爸很高。	 tā bàba hěn gāo。 	(很: hěn) Her father is tall.
你爸爸很高。	 nǐ bàba hěn gāo。 	(很: hěn) Your father is pretty tall.
你也很高。	 nǐ yě hěn gāo。 	(很: hěn) You are also tall.
我很高兴。	 wǒ hěn gāoxìng。 	(很: hěn) I am happy.
他很高兴。	 tā hěn gāoxìng。 	(很: hěn) He is happy.
他很高兴。	 tā hěn gāoxìng。 	(很: hěn) He is happy.
认识你很高兴。	 rènshi nǐ hěn gāoxìng。 	(很: hěn) Very happy to meet you.
鲍勃很高兴。	 bào bó hěn gāoxìng。 	(很: hěn) Bob was very happy.
今天我很高兴。	 jīntiān wǒ hěn gāoxìng。 	(很: hěn) I am very happy today.
认识你很高兴。	 rènshi nǐ hěn gāoxìng。 	(很: hěn) Nice to meet you.
每个人都很高兴。	 měigerén dōu hěn gāoxìng。 	(很: hěn) Every person is very happy.
这个问题也很麻烦。	 zhège wèntí yě hěn máfan。 	(很: hěn) This problem is also very troublesome.
我要多很多。	 wǒ yào duō hěn duō。 	(很多: hěnduō) I want much more.
这里的人很多。	 zhèlǐ de rén hěn duō。 	(很多: hěnduō) A lot of people here.
日本有很多中国人。	 Rìběn yǒu hěn duō Zhōngguórén。 	(很多: hěnduō) There are many Chinese people in Japan.
商店里有很多人。	 shāngdiàn lǐ yǒu hěn duō rén。 	(很多: hěnduō) The store had a lot of people.
很多人都喜欢你。	 hěn duō rén dōu xǐhuan nǐ。 	(很多: hěnduō) A lot of people like you.
很多人都想工作。	 hěn duō rén dōu xiǎng gōngzuò。 	(很多: hěnduō) A lot of people want to work.
很多咖啡厅都有wifi。	 hěn duō kāfēitīng dōu yǒuwifi。 	(很多: hěnduō) A lot of cafes have wifi.
世界上有很多国家。	 shìjiè shàng yǒu hěn duō guójiā。 	(很多: hěnduō) There are many countries in the world.
我家有很多小狗。	 wǒ jiā yǒu hěn duō xiǎogǒu。 	(很多: hěnduō) There are a lot of puppies in my home.
他有很多小狗。	 tā yǒu hěn duō xiǎogǒu。 	(很多: hěnduō) He has many puppies.
很多年轻人不运动。	 hěn duō niánqīngrén bù yùndòng。 	(很多: hěnduō) Many young people don't exercise.
安有很多朋友。	 ān yǒu hěn duō péngyou。 	(很多: hěnduō) Ann has many friends.
这个酒吧有很多美女。	 zhège jiǔbā yǒu hěn duō měinǚ。 	(很多: hěnduō) There are a lot of pretty girls in this bar.
他送给她很多花。	 tā sònggěi tā hěn duō huā。 	(很多: hěnduō) He gave her lots of flowers.
她总是买很多衣服。	 tā zǒngshì mǎi hěn duō yīfu。 	(很多: hěnduō) She always buys a lot of clothes.
我们要买很多酒。	 wǒmen yào mǎi hěn duō jiǔ。 	(很多: hěnduō) We need to buy a lot of wine.
水里有很多鱼。	 Shuǐlǐ yǒu hěn duō yú。 	(很多: hěnduō) There are a lot of fish in the water.
六除以二得三。	 liù chúyǐ èr dé sān。 	(得: dé) Six divided by two is three.
听得不清楚	 tīng dé bùqīngchu 	(得: dé) Not hear clearly
做得不好	 zuò dé bùhǎo 	(得: dé) Do poorly
吃得不好	 chī dé bùhǎo 	(得: dé) Eat poorly
想得好!。	 xiǎng dé hǎo!。 	(得: dé) Good thinking!
想得好!。	 xiǎng dé hǎo!。 	(得: dé) Good thinking!
做得好(Impliesanaction)	zuò dé hǎoImpliesanaction	(得: dé) )
问得好。	 wèn dé hǎo。 	(得: dé) Good question!
我生活得很幸福。	 wǒ shēnghuó dehěn xìngfú。 	(得: dé) I live a happy life.
笑得很开心	 xiào dehěn kāixīn 	(得: dé) Laugh happily
我们走得很慢。	 wǒmen zǒu dehěn màn。 	(得: dé) We walked slowly.
学得很认真	 xué dehěn rènzhēn 	(得: dé) Study seriously
比赛进行得很顺利。	 bǐsài jìnxíng dehěn shùnlì。 	(得: dé) The race went well.
走得快	 zǒu dé kuài 	(得: dé) Walk fast
说得快	 shuō dé kuài 	(得: dé) Speak fast
走得慢	 zǒu dé màn 	(得: dé) Walk slowly
他跑得真快。	 tā pǎo dé zhēn kuài。 	(得: dé) He ran really fast.
我不是德国人。	 wǒ bùshì Déguórén。 	(德国: déguó) I am not German.
我今天必须去上班。	 wǒ jīntiān bìxū qù shàngbān。 	(必须: bìxū) I have to go to work today.
不要忘了开会啊！	 bùyào wàng le kāihuì ā！ 	(忘: wàng) Don't forget to have the meeting!
别忘记刷牙。	 bié wàngjì shuāyá。 	(忘记: wàngjì) Don't forget to brush your teeth.
我今天忘记带钥匙。	 wǒ jīntiān wàngjì dài yàoshi。 	(忘记: wàngjì) I forgot to bring the key today.
我总是忘记这个词。	 wǒ zǒngshì wàngjì zhège cí。 	(忘记: wàngjì) I always forget this word.
我忙。	 wǒ máng。 	(忙: máng) I am busy.
她正忙。	 tā zhèng máng。 	(忙: máng) She's busy.
她很忙。	 tā hěn máng。 	(忙: máng) She's busy.
我很忙。	 wǒ hěn máng。 	(忙: máng) I am very busy.
我现在不忙。	 wǒ xiànzài bùmáng。 	(忙: máng) I'm not busy now.
我今天很忙。	 wǒ jīntiān hěn máng。 	(忙: máng) I'm very busy today.
我爸爸很忙。	 wǒ bàba hěn máng。 	(忙: máng) My father is busy.
我昨天不忙。	 wǒ zuótiān bùmáng。 	(忙: máng) I wasn't busy yesterday.
我昨天很忙。	 wǒ zuótiān hěn máng。 	(忙: máng) I was very busy yesterday.
我最近很忙。	 wǒ zuìjìn hěn máng。 	(忙: máng) I recently busy.
星期二我很忙。	 Xīngqī'èr wǒ hěn máng。 	(忙: máng) I am busy on Tuesday.
我一直很忙。	 wǒ yīzhí hěn máng。 	(忙: máng) I am always very busy.
我跟你一样忙。	 wǒ gēn nǐ yīyàng máng。 	(忙: máng) I am just as busy as you.
你多忙？	 nǐ duō máng？ 	(忙: máng) How busy are you?
你为什么总是这么忙？	 nǐ wèishénme zǒngshì zhème máng？ 	(忙: máng) Why are you always so busy?
我们已经很忙了。	 wǒmen yǐjīng hěn máng le。 	(忙: máng) We are already very busy.
你在忙什么呢？	 nǐ zài máng shénme ne？ 	(忙: máng) what are you busy with?
你忙吗？	 nǐ máng ma？ 	(忙: máng) Are you busy?
他忙吗？	 tā máng ma？ 	(忙: máng) Is he busy?
你忙吗？	 nǐ máng ma？ 	(忙: máng) Are you busy?
现在您忙吗？	 xiànzài nín máng ma？ 	(忙: máng) Are you busy now?
现在你忙吗？	 xiànzài nǐ máng ma？ 	(忙: máng) Are you busy now?
我快忙死了。	 wǒ kuài máng sǐ le。 	(忙: máng) I'm so/terribly busy!
火车没有飞机快。	 huǒchē méiyǒu fēijī kuài。 	(快: kuài) Train is not as fast airplane.
他跑得真快。	 tā pǎo dé zhēn kuài。 	(快: kuài) He ran really fast.
快三时了。	 kuài sān shí le。 	(快: kuài) It is almost three.
你快下班了吗？	 nǐ kuài xiàbān le ma？ 	(快: kuài) Are you going to get off work soon?
我们快到了。	 wǒmen kuài dàoliǎo。 	(快: kuài) We are about to arrive.
北京那么快地改变。	 Běijīng nàme kuài dì gǎibiàn。 	(快: kuài) Beijing is changing so rapidly.
水果快坏了。	 shuǐguǒ kuài huàile。 	(快: kuài) The fruit is almost ruined.
我快好了。	 wǒ kuài hǎole。 	(快: kuài) I'm almost ready.
衣服快干了。	 yīfu kuài gàn le。 	(快: kuài) The clothes are almost clean.
我快忙死了。	 wǒ kuài máng sǐ le。 	(快: kuài) I'm so/terribly busy!
快来吧！	 kuài lái ba！ 	(快: kuài) Come quick!
这个老人快死了。	 zhège lǎorén kuài sǐ le。 	(快: kuài) This old person is going to die soon.
杯子快满了。	 bēizi kuài mǎn le。 	(快: kuài) The cup is almost filled up.
快点啊！	 kuàidiǎn ā！ 	(快: kuài) Quickly!
快点儿，开会了！	 kuàidiǎnr， kāihuì le！ 	(快: kuài) Hurry up, it's time for the meeting now!
肉快熟了。	 ròu kuài shú le。 	(快: kuài) The meat is almost done [cooking].
快看那个烟。	 kuài kàn nàge yān。 	(快: kuài) Look at that smoke.
你们快结婚了？	 nǐmen kuài jiéhūn le？ 	(快: kuài) Are you soon getting married?
我快迟到了。	 wǒ kuài chí dàoliǎo。 	(快: kuài) I was almost late.
天快黑了。	 tiān kuài hēi le。 	(快: kuài) It's almost getting dark.
走得快	 zǒu dé kuài 	(快: kuài) Walk fast
说得快	 shuō dé kuài 	(快: kuài) Speak fast
祝你生日快乐！	 zhù nǐ shēngrìkuàilè！ 	(快乐: kuàilè) happy Birthday to you!
祝大家节日快乐！	 zhù dàjiā jiérì kuàilè！ 	(快乐: kuàilè) I wish everyone a happy holiday!
以前我很快乐。	 yǐqián wǒ hěn kuàilè。 	(快乐: kuàilè) Before, I was very happy.
我以前很快乐。	 wǒ yǐqián hěn kuàilè。 	(快乐: kuàilè) Before, I was very happy.
快点吃吧。	 kuàidiǎn chī ba。 	(快点: kuàidiǎn) Hurry up and eat.
你快要下班了吗？	 nǐ kuàiyào xiàbān le ma？ 	(快要: kuàiyào) Will you be getting off work soon?
快要六点了。	 kuàiyào liù diǎn le。 	(快要: kuàiyào) It's almost six.
我们快要到了。	 wǒmen kuàiyào dàoliǎo。 	(快要: kuàiyào) We will arrive soon.
这个老人快要死了。	 zhège lǎorén kuàiyào sǐ le。 	(快要: kuàiyào) This old person will die soon.
你们快要结婚了？	 nǐmen kuàiyào jiéhūn le？ 	(快要: kuàiyào) Will you soon be getting married?
用手机怎么上网？	 yòng shǒujī zěnme shàngwǎng？ 	(怎么: zěnme) How to use cellular internet
A:你怎么上网？	 A: nǐ zěnme shàngwǎng？ 	(怎么: zěnme) How do you go online?
今天怎么不冷？	 jīntiān zěnme bù lěng？ 	(怎么: zěnme) How is it not cold today?
你怎么不喝酒？	 nǐ zěnme bù hējiǔ？ 	(怎么: zěnme) How come you're not drinking?
这个孩子怎么不害羞？	 zhège háizi zěnme bù hàixiū？ 	(怎么: zěnme) Why is this child not shy?
你们怎么不开心？	 nǐmen zěnme bù kāixīn？ 	(怎么: zěnme) Why are you guys unhappy?
水怎么不热？	 shuǐ zěnme bù rè？ 	(怎么: zěnme) Why is the water not hot?
这个苹果怎么不甜？	 zhège píngguǒ zěnme bù tián？ 	(怎么: zěnme) Why isn't this apple sweet?
怎么不说话？	 zěnme bù shuōhuà？ 	(怎么: zěnme) Why don't you speak?
老师怎么不高兴？	 lǎoshī zěnme bù gāoxìng？ 	(怎么: zěnme) How come the teacher is unhappy?
你想怎么做？	 nǐ xiǎng zěnme zuò？ 	(怎么: zěnme) How do you do that?
中国菜怎么做？	 Zhōngguócài zěnme zuò？ 	(怎么: zěnme) How do you cook Chinese food?
怎么做饭？	 zěnme zuòfàn？ 	(怎么: zěnme) How do you cook?
怎么去？	 zěnme qù？ 	(怎么: zěnme) How do you get there?
你怎么去北京？	 nǐ zěnme qù Běijīng？ 	(怎么: zěnme) How you go to Beijing?
芒果怎么吃？	 mángguǒ zěnme chī？ 	(怎么: zěnme) How do you eat mangos?
这么多苹果怎么吃？	 zhème duō píngguǒ zěnme chī？ 	(怎么: zěnme) How do you eat so many apples?
我们应该怎么告诉他？	 wǒmen yīnggāi zěnme gàosu tā？ 	(怎么: zěnme) How should we tell him?
语法怎么学？	 yǔfǎ zěnme xué？ 	(怎么: zěnme) How do you study grammar?
你怎么学中文？	 nǐ zěnme xué Zhōngwén？ 	(怎么: zěnme) How do you study Chinese?
怎么学语法？	 zěnme xué yǔfǎ？ 	(怎么: zěnme) How do you study grammar?
太极拳怎么打？	 tàijíquán zěnme dǎ？ 	(怎么: zěnme) How do you do tai chi?
你怎么没写作业？	 nǐ zěnme méi xiě zuòyè？ 	(怎么: zěnme) Why haven't you done your homework?
你昨天怎么没回家？	 nǐ zuótiān zěnme méi huíjiā？ 	(怎么: zěnme) Why didn't you come home yesterday?
他怎么没来？	 tā zěnme méi lái？ 	(怎么: zěnme) What prevented him from coming?
你女朋友怎么没来？	 nǐ nǚpéngyou zěnme méi lái？ 	(怎么: zěnme) How come your girlfriend didn't come?
你怎么生气了？	 nǐ zěnme shēngqì le？ 	(怎么: zěnme) Why are you angry?
筷子怎么用？	 kuàizi zěnme yòng？ 	(怎么: zěnme) How do I use chopsticks?
怎么用筷子吃饭？	 zěnme yòng kuàizi chīfàn？ 	(怎么: zěnme) How do you use chopsticks to eat?
我怎么知道。	 wǒ zěnme zhīdào。 	(怎么: zěnme) How should I know.
我怎么知道?。	 wǒ zěnme zhīdào?。 	(怎么: zěnme) How should I know?
我怎么觉得这么累？	 wǒ zěnme juéde zhème lèi？ 	(怎么: zěnme) How can I feel this tired?
超市怎么走？	 chāoshì zěnme zǒu？ 	(怎么: zěnme) How do you get to the supermarket?
怎么跟女孩子说话？	 zěnme gēn nǚháizi shuōhuà？ 	(怎么: zěnme) How do you talk to girls?
这个孩子怎么这么害羞？	 zhège háizi zěnme zhème hàixiū？ 	(怎么: zěnme) How can this little girl be so shy?
水怎么这么热？	 shuǐ zěnme zhème rè？ 	(怎么: zěnme) How can the water be so hot?
这个苹果怎么这么甜？	 zhège píngguǒ zěnme zhème tián？ 	(怎么: zěnme) How can this apple be so sweet?
你怎么这么难过？	 nǐ zěnme zhème nánguò？ 	(怎么: zěnme) How can you be feeling this bad?
昨天怎么那么冷？	 zuótiān zěnme nàme lěng？ 	(怎么: zěnme) How could it be so cold yesterday?
他怎么那么懒？	 tā zěnme nàme lǎn？ 	(怎么: zěnme) How can he be this lazy?
川菜怎么那么辣？	 Chuāncài zěnme nàme là？ 	(怎么: zěnme) How can Sichuan food be so spicy?
他怎么那么高？	 tā zěnme nàme gāo？ 	(怎么: zěnme) How can you be so tall?
你怎么样？	 nǐ zěnmeyàng？ 	(怎么样: zěnmeyàng) How about you?
明天怎么样？	 míngtiān zěnmeyàng？ 	(怎么样: zěnmeyàng) How about for tomorrow?
生意怎么样？	 shēngyì zěnmeyàng？ 	(怎么样: zěnmeyàng) How's business?
生活怎么样？	 shēnghuó zěnmeyàng？ 	(怎么样: zěnmeyàng) How's life?
最近怎么样？	 zuìjìn zěnmeyàng？ 	(怎么样: zěnmeyàng) How have you been recently?
明天怎么样？	 míngtiān zěnmeyàng？ 	(怎么样: zěnmeyàng) How about for tomorrow?
天气怎么样？	 tiānqì zěnmeyàng？ 	(怎么样: zěnmeyàng) What's the weather like?
你母亲怎么样？	 nǐ mǔqīn zěnmeyàng？ 	(怎么样: zěnmeyàng) How's your mother?
你觉得这本书怎么样？	 nǐ juéde zhè běn shū zěnmeyàng？ 	(怎么样: zěnmeyàng) Do you think this book how?
你怎么样啊？	 nǐ zěnmeyàng ā？ 	(怎么样: zěnmeyàng) So how have you been?
天气怎样？	 tiānqì zěnyàng？ 	(怎样: zěnyàng) How is the weather?
请问怎样打电话到日本？	 qǐngwèn zěnyàng dǎdiànhuà dào Rìběn？ 	(怎样: zěnyàng) How can I make a telephone call to Japan?
我怕狗。	 wǒ pà gǒu。 	(怕: pà) I am afraid of dogs.
他怕狗。	 tā pà gǒu。 	(怕: pà) He's afraid of dogs.
我最怕猫。	 wǒ zuì pà māo。 	(怕: pà) I most fear cats.
不急。	 bù jí。 	(急: jí) There's no rush.
我们很急。	 wǒmen hěn jí。 	(急: jí) We're in a hurry.
急死了。	 jí sǐ le。 	(急: jí) I'm so/terribly anxious!
他总是一个人吃饭。	 tā zǒngshì yīgèrén chīfàn。 	(总是: zǒngshì) He always eats alone.
别总是不高兴。	 bié zǒngshì bù gāoxìng。 	(总是: zǒngshì) Don't always be unhappy.
她总是买很多衣服。	 tā zǒngshì mǎi hěn duō yīfu。 	(总是: zǒngshì) She always buys a lot of clothes.
他总是很早起床。	 tā zǒngshì hěn zǎo qǐchuáng。 	(总是: zǒngshì) He always got up very early.
他总是很累。	 tā zǒngshì hěn lèi。 	(总是: zǒngshì) He is always tired.
我总是忘记这个词。	 wǒ zǒngshì wàngjì zhège cí。 	(总是: zǒngshì) I always forget this word.
你不应该总是抱怨。	 nǐ bù yīnggāi zǒngshì bàoyuàn。 	(总是: zǒngshì) You shouldn't always complain.
她总是穿裙子。	 tā zǒngshì chuān qúnzi。 	(总是: zǒngshì) She always wears skirts.
你为什么总是这么忙？	 nǐ wèishénme zǒngshì zhème máng？ 	(总是: zǒngshì) Why are you always so busy?
你回家总是这么晚。	 nǐ huíjiā zǒngshì zhème wǎn。 	(总是: zǒngshì) You always come home really late.
中国菜总是这么油。	 Zhōngguócài zǒngshì zhème yóu。 	(总是: zǒngshì) Chinese food is always oily.
他总是迟到。	 tā zǒngshì chídào。 	(总是: zǒngshì) He is always late.
他做事总是那么慢。	 tā zuòshì zǒngshì nàme màn。 	(总是: zǒngshì) He always does things so slow.
海南总是那么热。	 Hǎinán zǒngshì nàme rè。 	(总是: zǒngshì) Hainan is always that hot.
中国人总是那么热情。	 Zhōngguórén zǒngshì nàme rèqíng。 	(总是: zǒngshì) Chinese people are always cordial.
她恨他。	 tā hèn tā。 	(恨: hèn) She hated him.
中国欢迎您！	 Zhōngguó huānyíng nín！ 	(您: nín) Welcome to China!
您下午做啥呢？	 nín xiàwǔ zuò shá ne？ 	(您: nín) So what will you do in the afternoon?
您不是医生。	 nín bùshì yīshēng。 	(您: nín) You are not a doctor.
欢迎您乘坐本次航班。	 huānyíng nín chéngzuò běn cì hángbān。 	(您: nín) Welcome aboard this flight.
您住在哪里？	 nín zhù zài nǎlǐ？ 	(您: nín) Where do you live?
您儿子多高？	 nín érzi duō gāo？ 	(您: nín) How tall is your son?
您叫什么名字？	 nín jiào shénme míngzi？ 	(您: nín) What is your name?
我欠您多少？	 wǒ qiàn nín duōshao？ 	(您: nín) How much do I owe you?
我不是您妈妈。	 wǒ bùshì nín māma。 	(您: nín) I'm not your mother.
现在您忙吗？	 xiànzài nín máng ma？ 	(您: nín) Are you busy now?
您想喝什么？	 nín xiǎng hē shénme？ 	(您: nín) What would you like to drink?
您是学生。	 nín shì xuésheng。 	(您: nín) You are a student.
您是学生吗？	 nín shì xuésheng ma？ 	(您: nín) Are you a student?
欢迎您来！	 huānyíng nín lái！ 	(您: nín) Welcome!
谢谢您的合作。	 xièxie nín de hézuò。 	(您: nín) Thank you for your cooperation.
六点您行吗？	 liù diǎn nín xíng ma？ 	(您: nín) Is 6 o'clock OK?
您贵姓？	 nín guìxìng？ 	(您: nín) What is your honorable surname?
老师，您好！	 lǎoshī， nínhǎo！ 	(您好: nínhǎo) Hello, teacher!
我要想一下。	 wǒ yào xiǎng yīxià。 	(想: xiǎng) I want to think a little.
你想不想我？	 nǐ xiǎng bùxiǎng wǒ？ 	(想: xiǎng) Do you or do you not miss me?
你想不想喝酒？	 nǐ xiǎng bùxiǎng hējiǔ？ 	(想: xiǎng) Do you want to drink alcohol or not?
你想不想她？	 nǐ xiǎng bùxiǎng tā？ 	(想: xiǎng) Do you miss her?
我想买些靴子。	 wǒ xiǎng mǎi xiē xuēzi。 	(想: xiǎng) I would like to purchase some boots.
我想买车。	 wǒ xiǎng mǎi chē。 	(想: xiǎng) I would like to buy a car.
我不想买车。	 wǒ bùxiǎng mǎi chē。 	(想: xiǎng) I wouldn't like to buy a car.
我想休息几分钟。	 wǒ xiǎng xiūxi jǐ fēnzhōng。 	(想: xiǎng) I want to rest a few minutes.
我会想你。	 wǒ huì xiǎng nǐ。 	(想: xiǎng) I'll miss you.
我想你了！	 wǒ xiǎng nǐ le！ 	(想: xiǎng) I miss you now!
我想出去走走。	 wǒ xiǎng chūqù zǒu zǒu。 	(想: xiǎng) I want to go out and walk for a bit.
我想去。	 wǒ xiǎng qù。 	(想: xiǎng) I would like to go.
我不想去。	 wǒ bùxiǎng qù。 	(想: xiǎng) I wouldn't like to go.
他不太想去。	 tā bù tài xiǎng qù。 	(想: xiǎng) He doesn't really want to go.
我想去中国。	 wǒ xiǎng qù Zhōngguó。 	(想: xiǎng) I'd like to go to China.
不想去了。	 bùxiǎng qù le。 	(想: xiǎng) I don't want to go anymore.
你想去吗？	 nǐ xiǎng qù ma？ 	(想: xiǎng) Would you like to go?
你想去哪儿？	 nǐ xiǎng qù nǎr？ 	(想: xiǎng) Where do you want to go?
我想去商店。	 wǒ xiǎng qù shāngdiàn。 	(想: xiǎng) I want to go to the store.
我想去学校。	 wǒ xiǎng qù xuéxiào。 	(想: xiǎng) I want to go to school.
我很想去法国。	 wǒ hěn xiǎng qù Fǎguó。 	(想: xiǎng) I would really like to go to France.
我不想去法国。	 wǒ bùxiǎng qù Fǎguó。 	(想: xiǎng) I wouldn't really like to go to France.
我太太想去泰国。	 wǒ tàitai xiǎng qù Tàiguó。 	(想: xiǎng) My wife would like to go to Thailand.
我想去那里。	 wǒ xiǎng qù nàli。 	(想: xiǎng) I wanted to go there.
我想吃。	 wǒ xiǎng chī。 	(想: xiǎng) I would like to eat.
我想吃。	 wǒ xiǎng chī。 	(想: xiǎng) I would like to eat.
我想吃个橙子。	 wǒ xiǎng chī gè chéngzi。 	(想: xiǎng) I'd like to eat an orange.
你想吃什么？	 nǐ xiǎng chī shénme？ 	(想: xiǎng) What would you like to eat?
你想吃吗？	 nǐ xiǎng chī ma？ 	(想: xiǎng) Do you want to eat?
你想吃吗？	 nǐ xiǎng chī ma？ 	(想: xiǎng) Do you want to eat?
她想吃吗？	 tā xiǎng chī ma？ 	(想: xiǎng) Does she want to eat?
我想吃块儿糖。	 wǒ xiǎng chī kuài r táng。 	(想: xiǎng) I eat pieces of sugar.
我想吃点东西。	 wǒ xiǎng chī diǎn dōngxi。 	(想: xiǎng) I want to eat something.
我想吃点东西。	 wǒ xiǎng chī diǎn dōngxi。 	(想: xiǎng) I'd like something to eat.
他想吃葡萄。	 tā xiǎng chī pútao。 	(想: xiǎng) He would like to eat grapes.
他不想吃葡萄。	 tā bùxiǎng chī pútao。 	(想: xiǎng) He wouldn't like to eat grapes.
你想吃香蕉吗？	 nǐ xiǎng chī xiāngjiāo ma？ 	(想: xiǎng) Do you want to eat bananas?
我想吃饭。	 wǒ xiǎng chīfàn。 	(想: xiǎng) I want to eat meal.
我不想吃饭。	 wǒ bùxiǎng chīfàn。 	(想: xiǎng) I wouldn't like to eat meal.
我想哭。	 wǒ xiǎng kū。 	(想: xiǎng) I want to cry.
我想喝一些牛奶。	 wǒ xiǎng hē yīxiē niúnǎi。 	(想: xiǎng) I want to drink some milk.
他想喝些冷饮。	 tā xiǎng hē xiē lěngyǐn。 	(想: xiǎng) He wants something cold to drink.
想喝什么？	 xiǎng hē shénme？ 	(想: xiǎng) What do you want to drink?
想喝什么？	 xiǎng hē shénme？ 	(想: xiǎng) What do you want to drink?
您想喝什么？	 nín xiǎng hē shénme？ 	(想: xiǎng) What would you like to drink?
你想喝什么？	 nǐ xiǎng hē shénme？ 	(想: xiǎng) What would you like to drink?
我想喝冷饮。	 wǒ xiǎng hē lěngyǐn。 	(想: xiǎng) I want to drink something cold.
我想喝咖啡。	 wǒ xiǎng hē kāfēi。 	(想: xiǎng) I'd like to drink coffee.
你想喝咖啡吗？	 nǐ xiǎng hē kāfēi ma？ 	(想: xiǎng) Would you like to drink coffee?
我想喝啤酒。	 wǒ xiǎng hē píjiǔ。 	(想: xiǎng) I would like to drink beer.
我不想喝啤酒。	 wǒ bùxiǎng hē píjiǔ。 	(想: xiǎng) I wouldn't like to drink beer.
我想喝水。	 wǒ xiǎng hē shuǐ。 	(想: xiǎng) I want to drink water.
B:我想喝茶。	 B: wǒ xiǎng hē chá。 	(想: xiǎng) I want to drink tea.
A:谁想喝茶？	 A: shéi xiǎng hē chá？ 	(想: xiǎng) Who wants to drink tea?
他想回家。	 tā xiǎng huíjiā。 	(想: xiǎng) He would like to return home.
他不想回家。	 tā bùxiǎng huíjiā。 	(想: xiǎng) He wouldn't like to return home.
他想在医院工作。	 tā xiǎng zài yīyuàn gōngzuò。 	(想: xiǎng) He wants to work in a hospital.
我想妈妈了。	 wǒ xiǎng māma le。 	(想: xiǎng) I miss my mom.
我也想学中文。	 wǒ yě xiǎng xué Zhōngwén。 	(想: xiǎng) I, too, want to study Chinese.
我不想工作。	 wǒ bùxiǎng gōngzuò。 	(想: xiǎng) I don't want to work.
很多人都想工作。	 hěn duō rén dōu xiǎng gōngzuò。 	(想: xiǎng) A lot of people want to work.
我想应该可以吧。	 wǒ xiǎng yīnggāi kěyǐ ba。 	(想: xiǎng) I think it should be OK.
想得好!。	 xiǎng dé hǎo!。 	(想: xiǎng) Good thinking!
想得好!。	 xiǎng dé hǎo!。 	(想: xiǎng) Good thinking!
你想怎么做？	 nǐ xiǎng zěnme zuò？ 	(想: xiǎng) How do you do that?
他想找一个工作。	 tā xiǎng zhǎo yī gè gōngzuò。 	(想: xiǎng) He tried to find a job.
我想星期六去北京。	 wǒ xiǎng Xīngqīliù qù Běijīng。 	(想: xiǎng) I want to go to Beijing on Saturday.
我想没关系。	 wǒ xiǎng méiguānxi。 	(想: xiǎng) I think it's OK.
她想洗脏衣服。	 tā xiǎng xǐ zāng yīfu。 	(想: xiǎng) She wanted to wash the dirty clothes.
我想活着。	 wǒ xiǎng huózhe。 	(想: xiǎng) I want to live.
我现在想点饮料。	 wǒ xiànzài xiǎng diǎn yǐnliào。 	(想: xiǎng) I would like to order drinks now.
我想玩电脑。	 wǒ xiǎng wán diànnǎo。 	(想: xiǎng) I want to play on the computer.
我想睡觉。	 wǒ xiǎng shuìjiào。 	(想: xiǎng) I want to sleep.
我想说再见。	 wǒ xiǎng shuō zàijiàn。 	(想: xiǎng) I want to say goodbye.
他想请我吃饭。	 tā xiǎng qǐng wǒ chīfàn。 	(想: xiǎng) He wanted to invite me to dinner.
我想骑马。	 wǒ xiǎng qímǎ。 	(想: xiǎng) I want to ride a horse.
我们有差不多的想法。	 wǒmen yǒu chàbuduōde xiǎngfǎ。 	(想法: xiǎngfǎ) We have more or less the same way of thinking.
你说说你的想法。	 nǐ shuōshuo nǐ de xiǎngfǎ。 	(想法: xiǎngfǎ) Talk a little bit about your opinion.
我们的想法差不多。	 wǒmen de xiǎngfǎ chàbuduō。 	(想法: xiǎngfǎ) Our ways of thinking are pretty much the same.
他想见我。	 tā xiǎngjiàn wǒ。 	(想见: xiǎngjiàn) He would like to see me.
他不想见我。	 tā bùxiǎng jiàn wǒ。 	(想见: xiǎngjiàn) He wouldn't like to see me.
祝你周末愉快！	 zhù nǐ zhōumòyúkuài！ 	(愉快: yúkuài) have a nice weekend!
这个词是什么意思？	 zhège cí shì shénme yìsi？ 	(意思: yìsi) What does the word mean?
我感觉今天有点儿冷。	 wǒ gǎnjué jīntiān yǒudiǎnr lěng。 	(感觉: gǎnjué) I feel a little cold today.
请向他表示感谢。	 qǐng xiàng tā biǎoshì gǎnxiè。 	(感谢: gǎnxiè) Please express our gratitude to him.
他很愿意帮助别人。	 tā hěn yuànyì bāngzhù biéren。 	(愿意: yuànyì) He was very willing to help others.
我们走得很慢。	 wǒmen zǒu dehěn màn。 	(慢: màn) We walked slowly.
他做事总是那么慢。	 tā zuòshì zǒngshì nàme màn。 	(慢: màn) He always does things so slow.
你慢死了。	 nǐ màn sǐ le。 	(慢: màn) You're so/terribly slow!
走得慢	 zǒu dé màn 	(慢: màn) Walk slowly
慢慢地说	 mànmàn dì shuō 	(慢慢: mànman) Slowly talk
天慢慢地黑了。	 tiān mànmàn dì hēi le。 	(慢慢: mànman) Days slowly dark.
我上午慢跑。	 wǒ shàngwǔ mànpǎo。 	(慢跑: mànpǎo) I jog in the morning.
我不太懂。	 wǒ bù tài dǒng。 	(懂: dǒng) I don't really understand.
他怎么那么懒？	 tā zěnme nàme lǎn？ 	(懒: lǎn) How can he be this lazy?
我等了五个小时。	 wǒděng le wǔ gè xiǎoshí。 	(我等: wǒděng) I waited for five hours.
星期六或者星期天都可以。	 Xīngqīliù huòzhě Xīngqītiān dōu kěyǐ。 	(或者: huòzhě) Saturday or Sunday are both ok.
战舰非常大。	 zhànjiàn fēicháng dà。 	(战舰: zhànjiàn) The battleship is very large.
他戴这个黑色眼镜。	 tā dài zhège hēisè yǎnjìng。 	(戴: dài) He wore the black glasses.
我没有房子。	 wǒ méiyǒu fángzi。 	(房子: fángzi) I don't have a house.
我们没有房子。	 wǒmen méiyǒu fángzi。 	(房子: fángzi) We don't have a house.
你有房子。	 nǐ yǒu fángzi。 	(房子: fángzi) You have a house.
这房子非常小。	 zhè fángzi fēicháng xiǎo。 	(房子: fángzi) That house is very small.
小李的房子	 xiǎo lǐ de fángzi 	(房子: fángzi) Xiaoli's house
这个房间不太大。	 zhège fángjiān bù tài dà。 	(房间: fángjiān) This apartment is not too big.
房间还算大。	 fángjiān hái suàn dà。 	(房间: fángjiān) The room is fairly big.
这里的房间都差不多。	 zhèlǐ de fángjiān dōu chàbuduō。 	(房间: fángjiān) The rooms here are all basically the same.
珍有五个手提袋。	 zhēn yǒu wǔ gè shǒutí dài。 	(手提袋: shǒutídài) Jane has five handbags.
这块手表600元。	 zhè kuài shǒubiǎo600 yuán。 	(手表: shǒubiǎo) The watch 600 yuan.
这块手表很贵。	 zhè kuài shǒubiǎo hěn guì。 	(手表: shǒubiǎo) This watch is very expensive.
这块手表非常漂亮。	 zhè kuài shǒubiǎo fēicháng piàoliang。 	(手表: shǒubiǎo) This watch is very beautiful.
现在才中午。	 xiànzài cái zhōngwǔ。 	(才: cái) It is just noon.
太极拳怎么打？	 tàijíquán zěnme dǎ？ 	(打: dǎ) How do you do tai chi?
你打不打球？	 nǐ dǎ bù dǎqiú？ 	(打: dǎ) Do you play ball?
弟弟正在打篮球。	 dìdi zhèngzài dǎ lánqiú。 	(打: dǎ) Brother playing basketball.
你经常打羽毛球吗？	 nǐ jīngcháng dǎ yǔmáoqiú ma？ 	(打: dǎ) You often play badminton it?
她会打鼓。	 tā huì dǎgǔ。 	(打: dǎ) She can play the drum.
请把行李箱打开。	 qǐng bǎ xínglixiāng dǎkāi。 	(打开: dǎkāi) Please open the trunk.
比尔打开了电视。	 Bǐ'ěr dǎkāi le diànshì。 	(打开: dǎkāi) Bill turned on the television.
对不起打扰你了。	 duìbuqǐ dǎrǎo nǐ le。 	(打扰: dǎrǎo) I'm sorry to bother you.
你打不打球？	 nǐ dǎ bù dǎqiú？ 	(打球: dǎqiú) Do you play ball?
他正在打电话。	 tā zhèngzài dǎdiànhuà。 	(打电话: dǎdiànhuà) He's talking on the telephone.
我要打电话。	 wǒ yào dǎdiànhuà。 	(打电话: dǎdiànhuà) I want to make a phone call.
我今晚给你打电话。	 wǒ jīnwǎn gěi nǐ dǎdiànhuà。 	(打电话: dǎdiànhuà) I'll ring you up tonight.
她承诺给我打电话。	 tā chéngnuò gěi wǒ dǎdiànhuà。 	(打电话: dǎdiànhuà) She's promised to give me a ring.
请问怎样打电话到日本？	 qǐngwèn zěnyàng dǎdiànhuà dào Rìběn？ 	(打电话: dǎdiànhuà) How can I make a telephone call to Japan?
他在打电话呢。	 tā zài dǎdiànhuà ne。 	(打电话: dǎdiànhuà) He called it.
有人打电话来。	 yǒurén dǎdiànhuà lái。 	(打电话: dǎdiànhuà) Someone called.
他没有打电话给我。	 tā méiyǒu dǎdiànhuà gěi wǒ。 	(打电话: dǎdiànhuà) He did not give me a call.
我要打电话订位子。	 wǒ yào dǎdiànhuà dìngwèi zǐ。 	(打电话: dǎdiànhuà) I want to call to make the reservation.
这里不能打车。	 zhèlǐ bùnéng dǎchē。 	(打车: dǎchē) I can't get a taxi here.
儿子非常害怕打针。	 érzi fēicháng hàipà dǎzhēn。 	(打针: dǎzhēn) Son very afraid of injections.
护士正在给病人打针。	 hùshi zhèngzài gěi bìngrén dǎzhēn。 	(打针: dǎzhēn) Nurse is giving the patient an injection.
不要扔在地上。	 bùyào rēng zài dìshang。 	(扔: rēng) Don't throw on the ground.
他想找一个工作。	 tā xiǎng zhǎo yī gè gōngzuò。 	(找: zhǎo) He tried to find a job.
她承诺给我打电话。	 tā chéngnuò gěi wǒ dǎdiànhuà。 	(承诺: chéngnuò) She's promised to give me a ring.
护士正在给病人打针。	 hùshi zhèngzài gěi bìngrén dǎzhēn。 	(护士: hùshì) Nurse is giving the patient an injection.
报名需要什么材料？	 bàomíng xūyào shénme cáiliào？ 	(报名: bàomíng) Registration required material?
你不应该总是抱怨。	 nǐ bù yīnggāi zǒngshì bàoyuàn。 	(抱怨: bàoyuàn) You shouldn't always complain.
公共场所禁止抽烟。	 gōnggòng chǎngsuǒ jìnzhǐ chōuyān。 	(抽烟: chōuyān) Ban smoking in public places.
我们拥有三架飞机。	 wǒmen yōngyǒu sān jià fēijī。 	(拥有: yǒngyǒu) We have three airplanes.
拿本书读！	 ná běn shū dú！ 	(拿: ná) Take a book and read it.
拿本书读！	 ná běn shū dú！ 	(拿: ná) Take a book and read it.
请先别挂电话。	 qǐng xiān bié guà diànhuà。 	(挂: guà) Please do not hang up.
我按时完成了任务。	 wǒ ànshí wánchéng le rènwu。 	(按时: ànshí) I completed the mission.
天气挺凉爽。	 tiānqì tǐng liángshuǎng。 	(挺: tǐng) The weather is quite pleasantly cool.
这本书挺好看的。	 zhè běn shū tǐng hǎokàn de。 	(挺: tǐng) This book is very good to see.
我回家换了衣服。	 wǒ huíjiā huàn le yīfu。 	(换: huàn) I went home to change clothes.
我们到车子后面推车。	 wǒmen dào chēzi hòumian tuīchē。 	(推车: tuīchē) We got behind the car and pushed.
我们提前完成了任务。	 wǒmen tíqián wánchéng le rènwu。 	(提前: tíqián) We are ahead of schedule.
和我握手。	 hé wǒ wòshǒu。 	(握手: wòshǒu) Shake my hand.
九支玫瑰	 jiǔ zhī méiguī 	(支: zhī) nine roses
我有十支笔。	 wǒ yǒu shí zhī bǐ。 	(支: zhī) I have ten pens.
收到一个信号。	 shōudào yī gè xìnhào。 	(收到: shōudào) Catch a signal.
我在收拾行李呢。	 wǒ zài shōushi xíngli ne。 	(收拾: shōushí) I pack yet.
北京那么快地改变。	 Běijīng nàme kuài dì gǎibiàn。 	(改变: gǎibiàn) Beijing is changing so rapidly.
我已经改变了计划。	 wǒ yǐjīng gǎibiàn le jìhuà。 	(改变: gǎibiàn) I have changed plans.
明天就要放暑假了。	 míngtiān jiùyào fàng shǔjià le。 	(放: fàng) Tomorrow the summer holidays.
把椅子放在桌子前面。	 bǎ yǐzi fàng zài zhuōzi qiánmiàn。 	(放在: fàngzài) Put the chair in front of the desk.
女人不太关心政治。	 nǚrén bù tài guānxīn zhèngzhì。 	(政治: zhèngzhì) Women are not too concerned about politics.
叫救护车。	 jiào jiùhùchē。 	(救护车: jiùhùchē) Call an ambulance!
李老师教我们数学。	 lǐ lǎoshī jiāo wǒmen shùxué。 	(教: jiào) Lee taught us mathematics.
李教授说话非常幽默。	 lǐ jiàoshòu shuōhuà fēicháng yōumò。 	(教授: jiàoshòu) Professor Lee spoke very humorous.
教育孩子要有耐心。	 jiàoyù háizi yàoyǒu nàixīn。 	(教育: jiàoyù) Teaching children to be patient.
你敢！	 nǐ gǎn！ 	(敢: gǎn) How dare you!
请把数字写清楚。	 qǐng bǎ shùzì xiě qīngchu。 	(数字: shùzì) Please write clearly digital.
李老师教我们数学。	 lǐ lǎoshī jiāo wǒmen shùxué。 	(数学: shùxué) Lee taught us mathematics.
葡萄五元一斤。	 pútao wǔ yuán yī jīn。 	(斤: jīn) Grape five yuan a pound.
电脑是新的。	 diànnǎo shì xīn de。 	(新: xīn) The computer is new.
我要买一个新手机。	 wǒ yào mǎi yī gè xīnshǒu jī。 	(新手机: xīnshǒujī) I want to buy a new cell phone.
我上网去看看新闻。	 wǒ shàngwǎng qù kànkan xīnwén。 	(新闻: xīnwén) I go online and look at the news.
公园里空气非常新鲜。	 gōngyuán lǐ kōngqì fēicháng xīnxiān。 	(新鲜: xīnxiān) The air is very fresh in the park.
这些都是新鲜水果。	 zhèxiē dōu shì xīnxiān shuǐguǒ。 	(新鲜: xīnxiān) These are fresh fruit.
我喜欢新鲜的果汁。	 wǒ xǐhuan xīnxiān de guǒzhī。 	(新鲜: xīnxiān) I like fresh fruit juice.
这样做多不方便！	 zhèyàng zuò duō bùfāngbiàn！ 	(方便: fāngbiàn) This is so inconvenient!
上海比别的城市方便。	 Shàng Hǎi bǐ biéde chéngshì fāngbiàn。 	(方便: fāngbiàn) Shanghai is more convenient than other cities.
住在上海非常方便。	 zhù zài Shàng Hǎi fēicháng fāngbiàn。 	(方便: fāngbiàn) It is very convenient to live in Shanghai.
坐我旁边。	 zuò wǒ pángbiān。 	(旁边: pángbiān) Sit beside me.
爸爸在我旁边。	 bàba zài wǒ pángbiān。 	(旁边: pángbiān) Dad next to me.
我们开车去旅游。	 wǒmen kāichē qù lǚyóu。 	(旅游: lǚyóu) We drove to the tour.
我下周去美国旅行。	 wǒ xiàzhōu qù Měiguó lǚxíng。 	(旅行: lǚxíng) Next week I go to U.S. to travel.
这个商店卖旧书。	 zhège shāngdiàn mài jiùshū。 	(旧书: jiùshū) This store sells old books.
巴士早了两分钟。	 bāshì zǎo le liǎng fēnzhōng。 	(早: zǎo) The bus was two minutes early.
邮局早上9点开门。	 yóujú zǎoshang diǎn kāimén。 	(早上: zǎoshang) Post offices open at 9 am.
我早上七点起床。	 wǒ zǎoshang qī diǎn qǐchuáng。 	(早上: zǎoshang) I get up at seven in the morning.
我早上不喂狗。	 wǒ zǎoshang bù wèi gǒu。 	(早上: zǎoshang) I don't feed my dog in the morning.
现在是早上八时。	 xiànzài shì zǎoshang bā shí。 	(早上: zǎoshang) It's eight o'clock in the morning.
9月9号早上六点	 9 yuè9 hào zǎoshang liù diǎn 	(早上: zǎoshang) September 9th, 6 o'clock a.m.
我早上看见过他。	 wǒ zǎoshang kànjiàn guò tā。 	(早上: zǎoshang) I saw him in the morning.
我每天早上都跑步。	 wǒ měitiān zǎoshang dōu pǎobù。 	(早上: zǎoshang) I run each morning.
你们早点来吧。	 nǐmen zǎodiǎn lái ba。 	(早点: zǎodiǎn) Come a little earlier.
他总是很早起床。	 tā zǒngshì hěn zǎo qǐchuáng。 	(早起: zǎoqǐ) He always got up very early.
我没有吃早饭。	 wǒ méiyǒu chī zǎofàn。 	(早饭: zǎofàn) I didn't eat breakfast.
我没吃早饭。	 wǒ méi chī zǎofàn。 	(早饭: zǎofàn) I didn't eat breakfast.
我早饭主要吃水果。	 wǒ zǎofàn zhǔyào chī shuǐguǒ。 	(早饭: zǎofàn) I mostly have fruit for breakfast.
快三时了。	 kuài sān shí le。 	(时: shí) It is almost three.
现在正是好时候。	 xiànzài zhèngshì hǎo shíhou。 	(时候: shíhòu) The present time is a good time.
你什么时候去理发？	 nǐ shénmeshíhou qù lǐfà？ 	(时候: shíhòu) When you get a haircut?
已经是时候回去了。	 yǐjīng shì shíhou huíqu le。 	(时候: shíhòu) It's already time to go home.
我现在没有时间。	 wǒ xiànzài méiyǒu shíjiān。 	(时间: shíjiān) I don't have time right now.
我现在没时间。	 wǒ xiànzài méi shíjiān。 	(时间: shíjiān) I don't have time right now.
给我一些时间。	 gěi wǒ yīxiē shíjiān。 	(时间: shíjiān) Give me some time.
这样做只是浪费时间。	 zhèyàng zuò zhǐshì làngfèi shíjiān。 	(时间: shíjiān) This is just a waste of time.
我时间不多。	 wǒ shíjiān bù duō。 	(时间: shíjiān) I don't have much time.
已经很长时间了。	 yǐjīng hěn cháng shíjiān le。 	(时间: shíjiān) It has already been a long time.
我没时间去北京。	 wǒ méi shíjiān qù Běijīng。 	(时间: shíjiān) I do not have time to go to Beijing.
我明年17岁。	 wǒ míngnián17 suì。 	(明年: míngnián) I'll be seventeen next year.
明年我要去中国。	 míngnián wǒ yào qù Zhōngguó。 	(明年: míngnián) Next year I am going to go to China.
上个星期去的地方	 shànggèxīngqī qù de dìfang 	(星期: xīngqí) The place we went to last week.
这个星期我上夜班。	 zhège xīngqī wǒ shàng yèbān。 	(星期: xīngqí) I'm doing night duty this week.
一个星期有七天。	 yī gè xīngqī yǒu qī tiān。 	(星期: xīngqí) One week has seven days.
五个星期	 wǔ gè xīngqī 	(星期: xīngqí) five weeks
两个星期	 liǎng gè xīngqī 	(星期: xīngqí) two weeks
九个半星期	 jiǔ gè bàn xīngqī 	(星期: xīngqí) nine and a half pieces of meat
今天是星期一吗？	 jīntiān shì Xīngqīyī ma？ 	(星期一: xīngqíyī) Is today Monday?
星期一我们要上班。	 Xīngqīyī wǒmen yào shàngbān。 	(星期一: xīngqíyī) We will go to work on Monday.
星期三上午九点	 Xīngqīsān shàngwǔ jiǔ diǎn 	(星期三: xīngqísān) Wednesday at 9 o'clock a.m.
星期三上午九点半	 Xīngqīsān shàngwǔ jiǔ diǎn bàn 	(星期三: xīngqísān) Wednesday at 9:30 a.m.
我星期三去中国。	 wǒ Xīngqīsān qù Zhōngguó。 	(星期三: xīngqísān) I went to China on Wednesday.